0 0 0 0 0 0 0 0 0 0 0 0 0 0 0 0 0 0 0 0 0 0 0 0 0 0 0 0 0 0 0 0 0 0 0 0 0 0 0 0 0 0 0 0 0 0 0 0 0 0 
0 0 0 0 0 0 0 0 0 0 0 0 0 0 0 0 0 0 0 0 0 0 0 0 0 0 0 0 0 0 0 0 0 0 0 0 0 0 0 0 0 0 0 0 0 0 0 0 0 0 
0 0 0 0 228 228 228 228 228 228 228 228 228 228 228 228 228 228 228 228 228 228 228 228 228 228 228 228 228 228 228 228 228 228 228 228 228 228 228 228 228 228 228 228 228 228 228 228 0 0 
0 0 0 0 228 228 228 228 228 228 228 228 228 228 228 228 228 228 228 228 228 228 228 228 228 228 228 228 228 228 228 236 229 228 228 228 228 228 228 228 228 228 228 228 228 228 228 228 0 0 
0 0 0 0 228 228 237 232 232 232 232 232 232 232 232 232 232 232 232 232 232 232 232 232 232 232 232 232 232 240 228 231 238 229 237 232 232 232 232 232 232 232 232 232 232 240 228 228 0 0 
0 0 0 0 228 228 230 237 232 232 232 232 232 232 232 232 232 232 232 232 232 232 232 232 232 232 232 232 240 235 240 235 232 234 230 237 232 232 232 232 232 232 232 232 240 231 228 228 0 0 
0 0 0 0 228 228 230 230 228 228 228 228 228 230 247 253 253 253 253 253 253 253 253 253 253 253 248 241 231 228 235 232 232 232 234 230 241 241 241 241 241 241 241 241 231 231 228 228 0 0 
0 0 0 0 228 228 230 230 228 236 229 228 237 242 250 254 254 254 254 254 254 254 254 254 254 254 249 241 231 228 228 228 230 259 260 234 241 241 261 241 247 253 248 241 231 231 228 228 0 0 
0 0 0 0 228 228 230 230 228 231 230 237 242 241 243 233 233 233 233 233 233 233 233 233 233 233 245 241 231 228 228 228 230 241 241 241 241 241 262 261 251 246 252 241 231 231 228 228 0 0 
0 0 0 0 228 228 230 230 228 231 230 230 241 241 231 236 233 233 233 233 233 233 233 233 233 229 230 241 244 240 236 229 230 241 241 241 241 241 241 262 250 254 249 241 231 231 228 228 0 0 
0 0 0 0 228 228 230 230 228 231 230 230 241 261 231 231 228 228 228 228 228 228 228 228 228 230 230 261 241 231 235 234 230 241 241 241 241 241 241 241 241 241 241 241 231 231 228 228 0 0 
0 0 0 0 228 228 230 230 228 231 230 230 241 262 231 235 232 228 228 228 228 228 228 228 232 234 230 262 243 239 228 228 230 241 241 241 241 241 241 241 241 241 241 241 231 231 228 228 0 0 
0 0 0 0 228 228 230 230 228 231 230 230 241 241 244 232 232 232 228 228 228 228 228 232 232 232 242 241 231 236 229 237 242 241 241 241 241 241 241 241 241 241 241 241 231 231 228 228 0 0 
0 0 0 0 228 228 230 230 228 235 234 230 241 241 241 241 241 241 241 241 241 241 241 241 241 241 241 241 231 231 230 230 241 241 241 241 241 241 243 245 241 241 241 241 231 231 228 228 0 0 
0 0 0 0 228 228 230 230 228 228 228 230 241 241 241 241 241 241 241 241 241 241 241 241 241 241 241 241 231 231 230 230 241 241 241 241 241 243 239 238 245 241 241 241 231 231 228 228 0 0 
0 0 0 0 228 228 230 230 228 236 229 238 233 233 245 241 261 241 241 241 241 241 241 241 241 241 241 241 231 235 234 230 241 241 241 241 243 239 228 228 230 241 241 241 231 231 228 228 0 0 
0 0 0 0 228 228 230 230 228 231 238 233 233 229 238 245 262 241 241 241 241 241 241 241 241 241 241 241 244 240 228 230 241 241 241 241 231 236 233 229 230 241 241 241 231 231 228 228 0 0 
0 0 0 0 228 228 230 230 228 231 228 228 228 238 229 238 233 233 233 233 233 233 245 241 241 241 241 241 241 244 240 230 241 241 241 241 231 235 240 230 230 241 241 241 231 231 228 228 0 0 
0 0 0 0 228 228 230 230 228 235 232 232 232 232 234 228 228 228 228 228 228 228 230 241 241 247 253 253 253 248 231 230 241 241 241 241 231 228 235 234 238 245 241 241 231 231 228 228 0 0 
0 0 0 0 228 228 230 230 232 232 232 232 232 232 232 232 232 232 232 232 232 232 242 241 241 251 246 246 258 249 231 230 241 241 241 241 244 232 232 232 232 242 241 241 231 231 228 228 0 0 
0 0 0 0 228 228 230 230 247 248 241 241 241 241 241 241 241 241 241 241 241 241 241 241 241 251 246 258 249 241 244 242 241 241 241 241 241 241 241 241 241 241 241 241 231 231 228 228 0 0 
0 0 0 0 228 228 230 230 251 255 248 241 241 241 241 241 241 241 241 241 241 241 241 241 241 251 258 249 261 241 241 241 241 241 241 241 241 241 241 241 241 241 241 241 231 231 228 228 0 0 
0 0 0 0 228 228 230 230 251 246 255 248 241 241 241 241 241 241 241 241 241 241 241 241 241 250 249 241 262 241 241 241 241 241 241 241 241 241 241 241 241 241 241 241 231 231 228 228 0 0 
0 0 0 0 228 228 230 230 251 246 246 255 248 241 241 241 241 241 241 241 241 261 243 233 233 233 233 233 233 233 233 233 233 233 233 233 233 233 233 233 245 241 241 241 231 231 228 228 0 0 
0 0 0 0 228 228 230 230 251 246 246 246 255 248 241 241 241 241 241 241 261 262 231 228 228 228 236 233 233 233 233 233 233 233 233 233 233 233 233 229 230 241 241 241 231 231 228 228 0 0 
0 0 0 0 228 228 230 230 250 254 254 254 254 249 241 241 241 241 241 241 262 241 244 240 228 228 235 232 232 232 232 232 232 232 232 232 232 232 232 234 230 241 241 241 231 231 228 228 0 0 
0 0 0 0 228 228 230 230 241 241 241 241 241 241 241 241 241 241 241 241 241 241 241 244 232 232 232 232 232 232 232 232 232 232 232 232 232 232 232 232 242 241 241 241 231 231 228 228 0 0 
0 0 0 0 228 228 230 230 241 241 241 241 241 241 241 241 241 241 241 241 241 241 241 241 241 241 241 241 241 241 241 241 241 241 241 241 241 241 241 241 241 241 241 241 231 231 228 228 0 0 
0 0 0 0 228 228 230 230 241 241 241 241 241 241 241 241 241 241 243 245 241 241 241 241 241 241 241 241 241 241 241 241 241 241 241 241 241 241 241 241 241 241 241 241 231 231 228 228 0 0 
0 0 0 0 228 228 230 230 241 241 241 241 241 241 243 233 233 233 239 238 245 241 241 241 241 243 233 233 233 245 241 261 241 241 243 233 233 233 233 233 245 241 241 241 231 231 228 228 0 0 
0 0 0 0 228 228 230 230 241 241 241 241 241 243 239 236 233 233 233 229 238 245 241 241 241 231 236 233 229 238 245 262 241 241 231 228 228 228 236 229 230 241 241 241 231 231 228 228 0 0 
0 0 0 0 228 228 230 230 241 241 241 241 243 239 236 239 236 229 228 238 229 230 241 241 241 231 235 232 234 228 238 245 241 241 231 228 228 236 228 230 230 241 241 241 231 231 228 228 0 0 
0 0 0 0 228 228 230 230 241 241 241 241 231 236 239 236 239 238 229 228 230 230 241 241 241 244 232 232 232 232 232 242 241 241 231 228 236 228 228 230 230 241 241 241 231 231 228 228 0 0 
0 0 0 0 228 228 230 230 241 241 241 241 231 231 236 228 228 237 234 228 230 230 241 241 241 241 241 241 241 241 241 241 241 241 231 236 228 236 229 230 230 241 241 241 231 231 228 228 0 0 
0 0 0 0 228 228 230 230 241 241 241 241 231 231 235 232 232 234 228 228 234 230 241 241 241 241 241 241 241 241 241 241 241 241 231 231 228 235 234 230 230 241 241 241 231 231 228 228 0 0 
0 0 0 0 228 228 230 230 241 241 241 241 231 235 232 232 232 232 232 234 228 230 241 241 241 241 241 241 241 241 241 241 241 241 231 231 228 228 228 230 230 241 241 241 231 231 228 228 0 0 
0 0 0 0 228 228 230 230 241 241 241 241 244 232 232 232 232 232 232 232 232 242 241 241 241 243 245 241 241 241 241 241 241 241 231 231 228 228 228 230 230 241 241 241 231 231 228 228 0 0 
0 0 0 0 228 228 230 230 241 241 241 241 241 241 241 241 241 241 241 241 241 241 241 241 241 231 238 245 241 241 241 241 241 241 231 231 228 228 228 230 230 241 241 241 231 231 228 228 0 0 
0 0 0 0 228 228 230 230 241 261 241 241 241 241 241 241 241 241 241 241 241 241 241 241 241 231 228 230 241 241 241 241 241 241 231 235 234 228 235 234 230 241 241 241 231 231 228 228 0 0 
0 0 0 0 228 228 230 230 241 262 241 241 241 247 253 253 253 253 248 241 241 241 241 241 241 231 228 230 261 241 241 241 241 241 231 228 228 228 228 237 234 241 241 241 231 231 228 228 0 0 
0 0 0 0 228 228 230 230 241 241 241 261 241 251 246 246 246 246 252 241 241 241 241 241 241 231 228 230 262 241 241 241 241 241 231 228 228 228 237 234 241 241 241 241 231 231 228 228 0 0 
0 0 0 0 228 228 230 230 241 247 248 262 241 251 246 246 246 246 252 241 241 241 241 241 261 231 228 230 241 261 241 241 241 241 235 242 241 244 234 241 241 241 241 241 231 231 228 228 0 0 
0 0 0 0 228 228 230 230 261 250 249 261 241 250 254 254 254 254 249 241 241 241 241 261 262 231 228 230 261 262 241 241 241 241 241 241 241 241 241 241 241 261 247 248 231 231 228 228 0 0 
0 0 0 0 228 228 230 230 262 241 241 262 241 241 241 241 241 241 241 241 241 241 241 262 241 231 228 230 262 241 241 241 241 241 241 241 241 241 241 241 241 262 250 249 231 231 228 228 0 0 
0 0 0 0 228 228 230 238 233 233 233 233 233 233 233 233 233 233 233 233 233 233 233 233 233 239 228 238 233 233 233 233 233 233 233 233 233 233 233 233 233 233 233 233 239 231 228 228 0 0 
0 0 0 0 228 228 238 233 233 233 233 233 233 233 233 233 233 233 233 233 233 233 233 233 233 233 233 233 233 233 233 233 233 233 233 233 233 233 233 233 233 233 233 233 233 239 228 228 0 0 
0 0 0 0 228 228 228 228 228 228 228 228 228 228 228 228 228 228 228 228 228 228 228 228 228 228 228 228 228 228 228 228 228 228 228 228 228 228 228 228 228 228 228 228 228 228 228 228 0 0 
0 0 0 0 228 228 228 228 228 228 228 228 228 228 228 228 228 228 228 228 228 228 228 228 228 228 228 228 228 228 228 228 228 228 228 228 228 228 228 228 228 228 228 228 228 228 228 228 0 0 
0 0 0 0 0 0 0 0 0 0 0 0 0 0 0 0 0 0 0 0 0 0 0 0 0 0 0 0 0 0 0 0 0 0 0 0 0 0 0 0 0 0 0 0 0 0 0 0 0 0 
0 0 0 0 0 0 0 0 0 0 0 0 0 0 0 0 0 0 0 0 0 0 0 0 0 0 0 0 0 0 0 0 0 0 0 0 0 0 0 0 0 0 0 0 0 0 0 0 0 0 
