0 0 0 0 0 0 0 0 0 0 0 0 0 0 0 0 0 0 0 0 0 0 0 0 0 0 0 0 0 0 0 0 0 0 0 0 0 0 0 0 0 0 0 0 0 0 0 0 0 0 
0 155 155 155 155 155 153 155 155 151 155 151 157 156 164 156 155 155 155 155 155 153 153 149 149 149 151 155 65 155 155 157 158 165 157 165 148 153 164 156 148 148 157 158 158 158 158 158 158 0 
0 155 14 155 155 155 153 155 155 151 65 157 158 158 156 164 158 158 158 158 158 156 153 149 149 149 151 155 155 155 155 155 148 157 165 157 158 156 153 148 148 148 148 148 148 148 148 148 148 0 
0 155 155 65 164 158 156 155 155 157 158 158 158 158 158 156 155 155 155 155 155 155 153 149 149 149 151 155 155 155 155 65 148 148 157 158 158 165 153 148 148 148 148 65 148 148 148 148 148 0 
0 158 158 158 156 155 155 164 158 158 158 158 158 158 158 158 165 164 158 158 158 158 221 149 149 149 222 158 158 158 165 155 148 148 148 148 148 157 156 148 148 65 148 148 148 148 148 148 65 0 
0 155 155 155 155 164 158 221 149 149 149 149 149 149 149 149 157 156 149 149 149 149 149 149 149 149 149 149 149 149 222 158 158 158 158 158 158 158 158 158 158 158 158 158 158 165 148 148 148 0 
0 155 155 164 158 221 149 149 149 149 149 149 149 149 149 170 149 149 149 149 149 149 149 168 149 149 168 149 149 149 149 149 149 149 149 149 149 149 149 149 149 149 149 149 149 222 158 165 148 0 
0 155 155 153 149 149 149 170 149 149 149 149 149 149 149 149 149 149 149 149 149 168 168 149 149 168 168 149 149 149 149 149 149 149 149 149 170 149 149 149 149 149 149 149 168 149 149 151 148 0 
0 155 155 153 149 149 168 149 149 149 170 170 170 170 170 170 168 168 149 149 149 149 149 149 149 168 149 149 149 149 168 168 168 168 168 149 149 149 149 149 149 149 149 149 149 168 149 151 148 0 
0 155 155 153 149 149 149 163 149 149 170 149 149 169 149 149 149 168 168 168 149 149 149 149 168 149 149 149 149 168 149 149 149 149 168 168 149 149 149 149 149 149 149 149 149 149 149 151 148 0 
0 65 155 153 149 149 169 169 149 149 149 149 150 152 220 149 149 149 149 168 168 168 168 168 168 149 170 149 149 168 149 149 149 149 149 149 168 168 168 168 168 168 168 149 149 149 149 151 148 0 
0 155 155 153 149 149 150 152 220 149 149 150 167 148 153 168 149 149 149 149 149 149 149 168 149 149 168 149 149 168 163 168 168 149 149 149 149 149 149 149 149 149 149 149 149 149 149 151 65 0 
0 155 155 153 149 149 151 155 166 152 152 167 148 148 166 152 152 152 152 152 220 149 149 149 149 149 168 163 163 150 220 149 149 168 168 149 150 152 220 149 149 168 149 149 149 163 149 151 148 0 
0 155 155 166 220 149 151 155 223 152 152 154 164 158 165 155 155 65 155 155 166 220 149 149 149 150 152 152 152 164 221 149 149 149 149 168 151 155 166 220 149 149 168 149 149 170 149 151 148 0 
0 148 155 155 153 149 151 65 151 223 154 153 153 163 151 155 155 155 223 152 154 166 220 149 149 222 158 158 158 221 149 149 149 149 149 149 151 65 155 166 220 149 149 149 149 149 149 151 148 0 
0 154 155 155 166 152 167 223 167 157 156 153 166 152 167 155 155 155 151 164 156 155 166 220 149 149 149 149 149 149 149 150 152 220 149 149 151 155 223 154 166 152 152 220 149 149 150 167 65 0 
0 166 154 155 155 155 155 157 158 158 158 156 155 155 65 155 65 155 157 156 155 155 65 166 152 152 152 152 152 152 152 167 65 153 149 149 151 155 157 156 164 158 158 221 149 149 222 165 148 0 
0 164 156 155 65 164 158 158 158 158 158 158 158 158 158 158 158 158 158 158 158 158 158 158 158 158 158 158 158 158 158 158 158 221 149 149 222 158 158 158 221 149 149 168 149 149 149 151 148 0 
0 156 155 148 164 221 170 149 149 149 149 149 149 149 149 163 168 149 149 149 149 149 149 149 149 149 149 168 149 149 149 149 149 149 149 149 149 168 168 168 168 149 149 149 149 149 149 151 148 0 
0 155 155 164 221 149 149 149 149 149 149 149 168 168 168 168 168 149 149 149 149 149 168 149 149 149 149 149 168 149 149 149 149 149 149 168 168 168 149 149 149 149 149 149 149 170 149 151 148 0 
0 155 155 153 149 149 149 149 149 168 149 149 149 149 149 149 149 149 149 149 149 168 149 149 149 149 149 168 149 149 149 149 149 168 168 168 149 149 149 149 149 149 149 149 149 149 149 151 148 0 
0 154 155 153 168 168 149 149 149 168 168 149 149 149 149 149 149 149 168 149 168 168 149 149 149 168 149 168 149 149 149 168 168 168 149 149 149 149 149 168 168 168 149 149 168 168 149 151 148 0 
0 166 154 153 149 149 149 149 149 149 149 149 149 149 149 149 170 150 152 152 152 152 220 149 149 168 168 149 149 149 149 149 149 149 149 149 149 149 149 149 168 149 149 149 168 168 149 151 148 0 
0 155 153 153 149 149 149 149 149 149 149 149 150 152 152 152 152 167 223 152 154 155 153 149 149 149 149 149 149 168 168 149 149 149 149 149 149 149 149 168 168 149 149 149 149 149 149 151 148 0 
0 155 153 153 163 149 149 149 168 149 149 150 167 65 155 155 155 223 155 155 155 154 166 152 220 149 149 149 149 168 149 149 149 149 149 149 149 149 149 168 149 149 149 149 149 163 149 151 65 0 
0 155 153 166 220 163 149 149 149 168 150 167 223 152 152 154 155 151 223 152 154 155 152 154 166 220 149 149 168 149 150 152 152 152 152 152 152 220 149 149 168 149 149 149 170 150 152 151 65 0 
0 155 153 155 166 220 149 149 168 150 167 223 167 223 154 166 152 167 157 158 156 155 155 155 154 166 220 149 149 150 167 65 155 223 152 152 154 166 152 152 152 152 152 152 152 148 148 151 148 0 
0 155 153 155 65 153 149 168 149 151 155 151 223 167 166 152 152 152 152 152 152 152 154 155 166 154 166 152 152 167 155 155 155 151 223 154 166 152 152 152 152 152 152 152 152 154 148 151 148 0 
0 155 153 155 65 153 149 149 149 151 65 151 151 65 223 152 152 152 152 152 154 155 166 154 155 166 154 155 65 155 155 155 155 151 151 155 152 152 152 152 152 152 152 154 148 153 148 151 148 0 
0 155 166 154 155 153 149 149 149 151 155 151 157 165 157 165 65 155 65 164 156 155 164 156 155 155 166 152 152 152 152 152 152 167 151 223 152 152 152 152 152 154 164 156 155 153 155 151 148 0 
0 154 155 166 154 153 168 149 149 222 165 157 165 157 165 157 158 158 158 156 155 164 156 164 158 158 158 158 158 158 165 155 223 152 155 151 155 65 155 65 148 153 153 155 155 153 155 151 148 0 
0 166 154 155 153 153 168 168 149 170 222 165 157 165 157 158 158 158 158 158 158 156 164 156 155 155 164 158 165 65 157 165 157 165 155 157 158 158 158 158 158 156 166 154 155 153 155 151 148 0 
0 155 166 154 153 166 220 149 149 149 168 222 165 157 158 158 158 158 158 158 158 158 156 164 158 158 221 149 222 165 155 157 165 157 158 158 158 158 158 158 158 158 158 156 155 153 148 151 148 0 
0 155 155 153 166 154 153 149 149 168 168 149 222 158 158 158 158 158 158 158 158 158 158 221 149 170 149 149 149 222 158 165 157 158 158 158 165 155 155 164 158 158 158 158 158 156 148 151 148 0 
0 155 155 166 154 153 153 149 149 168 149 149 149 149 149 149 149 149 149 149 149 149 149 149 149 168 168 168 149 149 149 222 158 165 155 155 157 158 158 156 155 155 155 155 155 148 148 151 148 0 
0 154 148 148 153 153 153 149 149 149 149 149 149 149 168 168 168 168 149 149 149 149 149 149 149 149 168 149 149 149 149 149 149 222 158 158 165 155 155 65 164 158 158 158 165 148 148 151 148 0 
0 153 148 148 153 153 153 149 149 149 149 149 168 168 168 149 149 168 168 168 149 149 149 149 149 168 168 149 149 170 149 149 149 149 149 149 222 158 158 158 221 149 168 168 222 165 148 151 65 0 
0 153 148 148 153 153 153 149 149 149 149 149 163 149 149 149 149 149 149 149 149 149 149 149 168 168 149 149 149 149 149 149 149 149 163 149 149 149 168 149 149 149 149 168 149 151 148 151 65 0 
0 153 148 148 153 153 166 152 152 152 220 149 163 149 149 149 149 168 149 149 149 149 170 168 149 149 149 168 149 149 149 149 149 149 168 149 149 149 149 149 149 149 149 149 163 151 148 151 148 0 
0 153 148 148 153 166 152 152 152 154 153 149 149 149 168 168 149 149 149 168 168 168 149 149 149 149 149 149 168 168 149 149 168 168 149 149 149 149 149 149 170 170 169 169 169 151 148 151 148 0 
0 153 155 148 166 152 152 152 154 153 153 149 149 149 149 168 149 168 168 168 149 149 149 149 150 152 152 152 152 220 149 149 168 149 149 149 149 149 149 149 149 149 150 152 152 167 148 151 65 0 
0 153 165 148 148 223 148 154 153 153 153 149 149 149 149 168 168 168 149 149 149 149 149 150 167 65 155 155 155 153 168 168 149 149 149 168 149 149 149 149 149 150 155 155 148 148 148 151 148 0 
0 155 157 165 148 151 148 153 153 153 153 149 163 149 149 149 149 149 149 149 168 149 149 151 223 152 152 152 154 166 152 220 149 149 149 168 168 170 149 149 150 155 155 148 148 148 148 151 148 0 
0 148 155 157 165 157 165 153 153 153 153 149 149 149 149 149 149 149 149 149 168 149 149 151 151 155 223 154 155 154 155 153 162 149 149 168 149 168 168 150 155 155 148 148 148 148 155 151 65 0 
0 148 155 148 157 165 157 156 153 153 166 152 152 152 152 152 220 149 149 149 163 168 150 167 157 155 157 156 155 155 154 153 148 162 223 152 152 152 152 155 148 148 148 148 148 155 155 151 148 0 
0 148 155 148 148 157 165 148 153 153 148 148 148 65 148 148 153 149 149 149 168 150 167 148 148 157 158 158 158 158 156 153 148 148 151 155 155 155 223 152 152 152 152 154 155 155 155 151 148 0 
0 154 155 148 148 148 157 165 153 153 148 148 148 148 148 65 153 149 149 168 150 167 65 148 148 148 148 148 148 148 164 156 148 148 151 155 155 223 148 223 152 154 148 148 154 148 148 157 165 0 
0 166 154 148 148 148 148 151 153 153 148 148 148 148 148 148 153 149 149 150 167 148 148 148 148 148 223 154 165 164 156 148 148 148 151 148 223 148 223 148 148 148 154 155 155 154 148 148 151 0 
0 148 166 154 148 148 148 151 153 166 152 152 152 152 152 154 166 152 152 152 152 152 152 152 152 152 167 148 157 156 167 148 148 148 151 223 148 148 151 148 223 154 148 154 148 148 152 152 167 0 
0 0 0 0 0 0 0 0 0 0 0 0 0 0 0 0 0 0 0 0 0 0 0 0 0 0 0 0 0 0 0 0 0 0 0 0 0 0 0 0 0 0 0 0 0 0 0 0 0 0 
