63 63 63 63 63 63 63 63 63 63 63 63 63 63 63 63 63 63 63 63 63 63 63 63 63 63 63 63 63 63 63 63 63 63 63 63 63 63 63 63 63 63 63 63 63 63 17 17 63 63 
63 3 3 3 3 3 3 3 3 3 3 3 3 3 3 3 63 3 3 3 3 3 3 3 3 3 3 3 3 3 3 3 3 3 3 3 3 3 3 3 3 3 3 3 3 3 17 17 3 63 
63 63 3 3 3 3 3 3 3 3 3 3 3 3 3 3 3 3 3 3 3 3 3 63 3 3 3 65 3 63 3 3 3 3 3 17 17 17 17 3 3 3 3 3 3 3 17 17 3 63 
63 65 63 3 3 3 3 63 3 3 3 63 3 3 3 65 3 3 17 17 3 3 3 3 3 3 3 3 3 3 3 3 3 3 3 3 3 17 17 17 17 3 3 3 17 17 17 17 3 63 
63 3 3 3 3 3 3 3 3 3 3 3 3 3 3 3 3 3 3 17 3 3 3 3 3 3 3 63 3 3 3 3 3 63 3 3 3 3 3 17 17 17 3 17 17 17 17 3 3 63 
63 3 3 3 3 65 3 3 3 3 3 3 3 3 3 63 3 3 3 17 17 17 3 65 3 3 3 3 3 3 65 3 3 3 3 3 3 3 3 3 17 17 17 17 17 17 3 3 3 63 
63 3 3 3 3 3 3 63 3 3 63 3 3 3 3 3 3 3 3 17 17 17 3 3 3 3 3 3 3 3 3 3 3 3 63 3 3 3 3 17 17 17 17 17 17 17 3 3 3 63 
63 3 3 3 3 3 3 3 3 3 3 3 3 3 3 3 17 17 17 17 17 17 17 3 3 3 3 3 3 3 63 3 3 3 3 3 17 17 17 17 17 17 17 17 3 3 65 3 3 63 
63 3 3 63 3 3 3 3 3 3 3 3 3 3 17 17 17 17 17 17 17 17 17 3 3 63 3 65 3 3 3 3 3 3 17 17 17 3 3 3 3 17 3 3 3 3 3 3 3 63 
63 3 3 3 3 3 3 3 3 3 65 3 17 17 17 17 17 3 3 3 3 3 17 17 3 3 3 3 3 3 3 17 17 17 17 3 3 3 3 3 17 17 3 3 3 3 3 3 3 63 
63 3 3 3 3 3 3 3 3 3 17 17 17 17 17 3 3 3 3 63 3 3 3 17 17 3 3 3 3 3 17 17 3 3 3 3 3 63 3 3 17 17 3 3 63 3 3 3 3 63 
63 3 3 3 3 63 3 3 17 17 17 17 17 17 3 3 3 3 3 3 3 3 3 17 17 3 3 3 17 17 17 3 3 3 3 3 3 3 3 3 17 17 17 3 3 3 3 63 3 63 
63 3 3 3 3 3 3 3 17 17 17 17 17 3 3 3 3 3 3 3 3 3 3 3 17 17 3 17 17 3 3 3 3 63 3 3 3 3 3 3 3 17 17 3 3 3 3 3 3 63 
63 3 3 3 3 3 3 3 17 17 17 17 3 3 3 3 3 63 3 3 3 3 3 3 17 17 17 17 3 3 3 3 3 3 3 3 3 3 3 63 3 17 17 3 3 3 3 3 3 63 
63 3 3 3 3 3 3 3 3 3 3 3 3 3 3 3 65 3 3 3 3 63 3 3 3 17 17 3 3 3 3 65 3 3 3 3 3 3 3 3 3 3 17 17 3 63 3 3 3 63 
63 3 3 3 3 3 3 3 3 3 63 3 3 3 3 3 3 3 3 3 3 3 3 3 3 17 17 17 3 3 3 3 3 63 3 3 3 3 3 3 3 3 17 17 3 3 3 3 3 63 
63 3 63 3 3 3 3 3 3 3 3 3 3 3 3 3 3 3 3 3 3 3 3 3 3 3 17 17 17 17 17 3 3 3 3 3 3 3 3 3 63 3 3 17 3 3 3 3 3 63 
63 3 3 3 3 3 65 3 3 3 3 3 3 3 3 3 3 3 65 3 3 3 3 3 63 17 17 17 3 17 17 3 3 3 3 3 63 3 3 3 3 3 17 17 17 3 3 3 3 63 
63 3 3 3 3 3 3 3 3 3 3 3 3 63 3 3 3 3 63 3 3 3 3 3 17 17 3 3 3 17 3 3 3 3 3 3 3 3 3 3 3 17 17 17 3 3 3 3 3 63 
63 3 17 17 3 3 3 3 3 3 3 3 3 3 3 3 3 3 3 3 3 3 3 17 17 17 3 3 17 17 3 3 3 3 3 3 3 3 3 3 17 17 17 3 3 3 63 3 3 63 
63 3 17 17 17 17 3 3 3 3 3 3 3 3 3 3 3 3 3 3 3 3 17 17 17 3 3 3 17 17 3 63 3 3 3 3 3 3 17 17 17 3 3 3 3 3 3 3 3 63 
63 3 3 3 17 17 17 3 3 3 3 3 3 3 3 3 65 3 3 3 17 17 17 17 3 3 3 17 17 17 3 65 3 3 3 3 17 17 17 17 3 3 63 3 3 3 3 3 3 63 
63 3 3 3 3 17 17 17 3 3 3 3 63 3 3 3 3 3 3 3 17 17 17 3 3 3 17 17 3 17 3 3 3 3 3 17 17 17 17 3 3 3 3 3 3 3 3 65 3 63 
63 3 3 3 3 3 17 17 17 3 3 3 3 3 3 3 3 3 17 17 17 3 3 3 3 3 17 3 3 17 17 3 3 3 17 17 17 17 17 3 3 3 3 3 3 3 3 3 3 63 
63 3 3 3 3 3 3 17 17 17 3 3 3 3 3 3 3 17 17 17 3 3 3 3 63 3 3 3 3 3 17 3 3 17 17 3 3 17 17 17 3 65 3 3 63 3 3 3 3 63 
63 3 3 3 3 3 3 3 17 17 17 3 3 3 3 17 17 17 3 3 3 3 3 3 3 3 3 3 65 3 17 17 17 17 3 3 3 3 17 17 3 3 3 3 3 3 3 63 3 63 
63 3 3 3 3 65 3 3 3 17 17 17 17 17 17 17 3 3 3 3 63 3 3 3 3 3 3 3 3 3 17 17 17 3 3 3 3 3 17 17 17 3 3 3 3 3 3 3 3 63 
63 3 3 3 3 3 3 65 3 3 3 17 17 17 17 17 3 3 3 3 3 3 3 3 3 3 63 3 3 3 17 17 3 3 3 3 3 3 3 17 17 17 3 3 3 63 3 3 3 63 
63 3 3 3 3 3 3 3 3 3 3 3 17 17 17 17 17 3 3 3 3 3 3 65 3 3 63 3 3 3 17 17 3 3 3 65 3 3 3 3 17 17 3 3 3 3 3 65 3 63 
63 3 3 65 3 3 3 3 3 3 3 3 3 3 17 17 17 17 17 3 3 3 3 3 3 3 3 3 3 3 17 17 3 3 3 3 3 3 3 3 17 17 17 3 63 3 3 3 3 63 
63 3 3 3 3 3 3 3 3 3 3 3 3 3 3 3 3 17 17 3 3 3 3 3 3 3 3 3 3 3 3 17 3 3 3 3 3 3 3 3 3 17 17 3 3 3 3 3 3 63 
63 3 3 3 3 3 3 3 3 3 65 3 3 3 3 3 3 17 17 3 3 3 3 3 3 3 3 3 3 3 3 17 17 3 3 3 3 3 3 3 3 17 17 17 3 3 3 3 3 63 
63 3 3 3 3 3 3 3 3 3 3 3 3 3 3 3 3 17 17 17 3 3 3 3 3 3 63 3 3 17 17 17 17 3 3 3 3 3 3 3 3 17 17 17 17 17 65 3 3 63 
63 3 3 3 3 3 3 3 3 17 17 3 3 17 17 17 17 17 17 17 3 3 3 63 3 3 3 3 3 17 17 17 17 3 3 3 3 65 3 3 3 3 3 17 17 17 3 3 3 63 
63 3 3 63 3 3 3 3 3 3 17 17 17 17 17 17 17 3 3 17 17 3 3 3 3 3 3 3 3 17 17 3 17 17 3 3 3 3 3 3 3 3 3 3 17 17 3 3 3 63 
63 3 3 3 3 3 3 3 3 3 17 17 3 3 3 3 3 3 3 17 17 17 3 3 63 3 3 3 17 17 17 3 3 3 17 17 3 3 3 3 63 3 3 3 17 17 3 3 63 63 
63 3 3 3 3 3 63 3 3 3 17 17 3 3 3 3 3 3 65 3 3 17 17 3 3 3 3 17 17 17 3 3 3 3 3 17 3 3 3 3 3 3 3 3 17 17 3 3 3 63 
63 3 3 3 3 3 3 3 3 3 17 17 3 3 3 3 3 3 3 3 3 17 17 3 3 3 17 17 17 3 3 3 3 3 3 17 17 3 3 3 3 3 3 17 17 17 3 3 3 63 
63 3 3 3 3 3 65 3 3 3 3 17 17 3 3 3 3 3 3 3 3 3 17 17 17 17 17 17 3 63 3 3 3 65 3 17 17 17 17 3 3 3 3 17 17 17 3 3 3 63 
63 3 3 65 3 3 3 3 3 3 3 17 17 3 3 65 3 3 3 3 3 17 17 17 17 17 17 3 3 3 3 3 3 3 3 3 3 17 17 17 17 17 3 17 17 3 3 3 3 63 
63 3 3 3 3 3 3 3 3 3 3 3 17 17 3 3 3 3 3 17 17 17 17 17 17 17 3 3 3 3 3 3 3 3 3 3 3 3 3 3 3 17 17 17 17 3 63 3 3 63 
63 3 3 3 3 3 3 3 63 3 3 3 3 17 17 3 3 3 3 17 17 3 3 17 17 3 3 3 3 63 3 3 3 3 3 3 3 3 3 3 3 3 17 17 3 3 3 3 3 63 
63 3 3 3 3 63 3 3 3 3 3 3 65 3 17 17 17 3 3 17 17 3 3 3 3 3 3 3 3 3 3 3 3 3 65 3 3 3 3 3 3 3 17 17 3 3 3 3 3 63 
63 3 3 3 3 3 3 3 3 3 3 3 3 17 17 17 17 17 17 17 3 3 3 65 3 63 3 3 3 3 65 3 3 3 3 3 3 3 63 3 3 3 17 17 3 3 65 3 3 63 
63 3 65 3 3 3 3 3 3 17 17 3 17 17 17 17 17 17 17 17 3 3 3 3 3 3 3 3 3 3 3 3 3 3 3 3 3 3 3 3 17 17 17 17 3 3 3 3 3 63 
63 3 3 3 3 3 3 3 3 17 17 17 17 17 17 17 17 17 17 17 17 3 3 3 3 3 3 3 3 17 17 17 17 17 17 17 17 17 17 17 17 3 17 17 17 3 3 3 3 63 
63 3 3 3 3 3 3 3 17 17 17 17 3 3 3 3 3 3 3 17 17 17 3 65 3 3 17 17 17 17 17 3 3 3 3 3 3 63 3 3 3 3 3 3 17 17 3 3 3 63 
63 3 3 3 3 17 17 17 17 17 17 3 3 3 3 65 3 3 3 17 17 17 17 17 17 17 17 17 3 3 3 63 3 3 3 63 3 3 3 65 65 3 63 3 3 17 17 3 3 63 
63 3 3 3 3 17 17 17 17 17 3 3 3 3 3 3 3 3 3 3 3 17 17 17 17 17 3 3 3 3 3 3 3 3 3 3 3 3 3 3 63 3 3 3 3 3 3 3 3 63 
63 63 63 63 63 63 63 63 63 63 63 63 63 63 63 63 63 63 63 63 17 17 17 17 17 17 63 63 63 63 63 63 63 63 63 63 63 63 63 63 63 63 63 63 63 63 63 63 63 63 
