0 0 0 0 0 0 0 0 0 0 0 0 0 0 0 0 0 0 0 0 0 0 0 0 0 0 0 0 0 0 0 0 0 0 0 0 0 0 0 0 0 0 0 0 0 0 0 0 0 0 
0 72 72 72 72 72 72 72 72 72 72 72 72 72 72 72 72 72 72 72 72 72 72 215 2 2 2 2 2 2 216 72 72 72 72 72 72 72 72 72 72 72 72 72 72 72 72 72 72 0 
0 72 72 72 72 72 72 72 72 72 72 72 72 72 72 72 72 72 72 72 72 72 72 215 2 2 2 2 2 2 216 72 72 72 72 72 72 72 72 72 72 72 72 72 72 72 72 72 72 0 
0 72 72 72 226 217 217 217 217 217 217 217 217 217 217 217 217 217 225 72 72 72 72 215 2 90 89 88 2 2 216 72 72 72 72 72 72 72 72 72 72 72 72 72 72 72 72 72 72 0 
0 72 72 72 215 219 2 2 2 2 2 2 2 2 2 2 2 219 216 72 72 72 72 215 90 113 114 87 2 219 2 217 217 217 217 217 217 217 217 217 217 217 217 217 217 217 225 72 72 0 
0 72 72 72 215 2 2 218 218 218 218 218 218 218 218 2 2 2 216 72 72 72 72 215 83 111 17 87 2 2 2 2 2 2 2 2 2 2 2 2 2 2 2 2 2 2 216 72 72 0 
0 72 72 72 215 2 216 72 72 72 72 72 72 72 72 215 2 2 2 217 217 217 217 2 2 83 84 86 2 2 2 218 218 218 218 218 218 218 218 218 218 218 218 218 2 2 216 72 72 0 
0 72 72 72 215 2 216 72 72 72 72 72 72 72 72 215 90 89 89 89 89 89 89 89 89 89 88 2 2 2 216 72 72 72 72 72 72 72 72 72 72 72 72 72 215 2 216 72 72 0 
0 72 72 72 215 2 216 72 72 72 72 72 72 72 72 215 91 115 92 84 84 84 84 84 84 111 87 2 2 2 216 72 72 72 72 72 72 72 72 72 72 72 72 72 215 2 216 72 72 0 
0 72 72 72 215 2 216 72 72 72 72 72 72 72 72 215 83 84 86 2 2 2 2 2 2 83 86 2 2 2 216 72 72 72 72 72 72 72 72 72 72 72 72 72 215 2 216 72 72 0 
0 72 72 72 215 2 2 217 217 217 217 217 217 217 217 2 2 2 2 218 218 218 218 2 2 2 2 2 2 2 216 72 72 72 72 72 72 72 72 72 72 72 72 72 215 2 216 72 72 0 
0 72 72 72 215 90 89 89 89 89 89 89 88 2 2 2 2 2 216 72 72 72 72 215 2 2 2 2 2 2 2 217 217 217 217 217 217 217 217 217 217 217 217 217 2 2 216 72 72 0 
0 72 72 72 215 83 84 84 84 84 84 84 86 2 2 2 2 2 216 72 72 72 72 215 20 22 2 2 2 2 2 2 90 89 89 88 2 2 2 2 2 2 2 2 2 2 216 72 72 0 
0 72 72 72 215 2 2 2 218 218 218 218 218 218 218 218 218 218 224 72 72 72 72 215 25 27 2 2 2 2 2 90 113 115 92 86 2 2 2 2 2 2 2 2 2 219 216 72 72 0 
0 72 72 72 215 2 2 216 72 72 72 72 72 72 72 72 72 72 72 72 72 72 72 227 218 218 218 218 218 218 2 83 111 92 86 2 218 218 218 218 218 218 218 2 2 2 224 72 72 0 
0 72 72 72 215 2 2 216 72 72 72 72 72 72 72 72 72 72 72 72 72 72 72 72 72 72 72 72 72 72 215 2 83 86 2 216 72 72 72 72 72 72 72 215 2 216 72 72 72 0 
0 72 72 72 215 2 2 216 72 72 72 72 72 72 72 72 72 72 72 72 72 72 72 72 72 72 72 72 72 72 215 2 2 2 2 216 72 226 217 217 217 217 217 2 2 2 217 225 72 0 
0 72 72 72 215 2 2 216 72 72 72 72 72 72 72 72 72 72 72 72 72 72 72 72 72 72 72 72 72 72 215 2 90 88 2 216 72 215 2 2 2 2 2 2 2 2 2 216 72 0 
0 72 72 72 215 2 2 2 217 217 217 217 217 217 217 217 217 217 217 217 217 217 217 225 72 72 72 72 72 72 215 90 113 87 2 216 72 215 2 2 2 2 2 20 21 21 22 216 72 0 
0 72 72 72 215 2 2 2 20 21 22 2 2 2 2 2 2 2 2 2 2 2 219 216 72 72 72 72 72 72 215 91 17 87 2 216 72 215 2 2 2 2 20 31 18 19 24 216 72 0 
0 72 72 72 215 2 2 2 25 26 27 2 2 90 88 2 2 20 22 2 2 2 219 216 72 72 72 72 72 72 215 91 17 87 2 216 72 215 2 2 2 20 31 18 18 18 24 216 72 0 
0 72 72 72 215 2 2 2 2 2 2 2 2 83 86 2 2 25 27 2 2 2 219 216 72 72 72 72 72 72 215 91 17 87 2 216 72 215 2 2 20 31 19 19 18 18 24 216 72 0 
0 72 72 72 215 2 2 2 218 218 218 218 218 218 218 218 218 218 218 218 218 218 218 224 72 72 72 72 72 72 215 91 17 87 2 216 72 215 2 2 23 18 18 18 18 18 24 216 72 0 
0 72 72 72 215 2 2 216 72 72 72 72 72 72 72 72 72 72 72 72 72 72 72 72 72 72 72 72 72 72 215 91 114 87 2 216 72 215 2 2 23 19 18 19 19 19 24 216 72 0 
0 72 72 72 215 2 2 2 217 217 217 217 217 217 217 217 217 217 217 217 217 217 217 217 217 217 217 217 217 217 2 83 111 87 2 216 72 215 2 2 23 18 18 18 19 18 24 216 72 0 
0 72 72 72 215 2 2 2 2 2 2 2 2 2 2 2 2 2 2 2 2 2 2 2 2 2 2 2 2 2 2 2 83 86 2 216 72 215 2 2 23 19 19 18 18 28 27 216 72 0 
0 72 72 72 215 2 2 2 2 2 2 2 2 2 2 2 2 2 2 2 2 2 2 2 2 2 2 2 2 2 2 2 2 2 2 216 72 215 2 2 25 26 26 26 26 27 2 216 72 0 
0 72 72 72 215 2 2 2 218 218 218 218 218 218 218 218 218 218 218 218 218 218 218 218 218 218 218 218 218 218 2 2 2 2 2 216 72 215 2 2 2 2 2 2 2 2 2 216 72 0 
0 72 72 72 215 2 2 216 72 72 72 72 72 72 72 72 72 72 72 72 72 72 72 72 72 72 72 72 72 72 215 2 2 2 2 216 72 215 219 2 219 2 219 2 219 2 219 216 72 0 
0 72 72 72 215 2 2 216 72 72 72 72 72 72 72 72 72 72 72 72 72 72 72 72 72 72 72 72 72 72 215 2 2 2 2 216 72 227 218 218 218 218 218 218 218 218 218 224 72 0 
0 72 72 72 215 2 2 2 217 217 217 217 217 225 72 72 72 72 72 72 72 72 72 72 72 72 72 72 72 72 215 2 2 2 2 216 72 72 72 72 72 72 72 72 72 72 72 72 72 0 
0 72 72 72 215 2 2 2 2 20 21 21 22 216 72 72 72 72 226 217 217 217 225 72 72 72 72 72 72 72 215 2 2 2 2 2 217 217 217 217 217 217 217 225 72 72 72 72 72 0 
0 72 72 72 215 2 2 2 20 31 18 19 24 216 72 72 72 72 215 219 219 219 216 72 72 72 72 72 72 72 215 20 22 2 90 89 89 89 88 2 2 2 2 2 217 217 225 72 72 0 
0 72 72 72 215 2 2 20 31 18 19 19 24 216 72 72 72 72 215 2 2 2 216 72 72 72 72 72 72 72 215 23 30 22 83 111 17 17 112 88 2 2 2 2 219 219 216 72 72 0 
0 72 72 72 215 2 2 23 18 18 18 28 27 216 72 72 72 72 215 2 2 2 216 72 72 72 72 72 72 72 215 25 26 27 2 83 84 84 84 86 2 2 2 2 2 219 216 72 72 0 
0 72 72 72 215 2 2 23 19 19 28 27 2 216 72 72 72 226 2 2 2 2 216 72 72 72 72 72 72 72 227 218 218 218 218 218 218 218 218 218 218 218 218 2 2 2 216 72 72 0 
0 72 72 72 215 2 2 25 26 26 27 2 2 219 217 217 217 90 89 89 88 2 216 72 72 72 72 72 72 72 72 72 72 72 72 72 72 72 72 72 72 72 72 215 2 2 216 72 72 0 
0 72 72 72 215 2 2 2 2 2 2 2 2 2 2 2 90 113 114 92 86 2 2 217 217 217 217 217 217 217 217 217 217 217 217 225 72 72 72 72 72 72 72 215 2 2 216 72 72 0 
0 72 72 72 215 219 2 2 90 89 89 89 89 89 89 89 113 17 92 86 2 2 2 2 2 2 2 2 2 2 2 2 2 219 219 216 72 72 72 72 72 72 72 215 2 2 216 72 72 0 
0 72 72 72 215 219 219 2 83 84 84 84 84 84 84 84 84 84 86 2 2 2 2 2 2 2 219 219 219 2 2 2 2 2 219 216 72 72 72 72 72 72 72 215 2 2 216 72 72 0 
0 72 72 72 227 218 218 218 218 218 218 218 218 218 218 218 218 218 218 218 218 218 218 218 218 218 218 218 218 218 218 218 218 218 218 224 72 72 72 72 72 72 72 215 2 2 216 72 72 0 
0 72 72 72 72 72 72 72 72 72 72 72 72 72 72 72 72 226 217 217 217 217 217 217 217 217 217 225 72 72 226 217 217 217 217 217 225 72 72 72 72 72 72 215 2 2 216 72 72 0 
0 217 217 217 217 217 217 217 217 225 72 72 72 72 72 72 226 219 241 241 241 241 241 241 241 241 241 241 225 226 241 243 233 233 233 233 233 229 72 72 72 72 72 215 2 2 216 72 72 0 
0 21 22 2 2 2 2 2 2 216 72 72 72 226 217 217 219 241 241 241 241 241 241 241 241 241 241 241 241 241 241 231 236 233 233 233 229 228 229 72 72 72 72 215 2 2 216 72 72 0 
0 29 30 22 2 20 21 22 2 216 72 72 72 215 241 241 241 241 241 241 243 233 233 233 233 233 245 241 241 241 241 231 231 236 233 229 238 229 230 72 72 72 72 215 2 2 216 72 72 0 
0 25 29 30 21 31 19 24 2 216 72 72 72 215 241 247 253 248 241 243 239 228 236 233 233 229 238 245 241 241 241 231 231 244 232 234 228 230 230 72 72 226 217 2 2 2 216 72 72 0 
0 2 25 26 26 26 26 27 2 216 72 72 72 215 241 250 254 249 243 239 228 236 239 228 228 238 229 238 245 241 243 239 235 232 259 260 232 234 238 233 233 2 241 2 241 2 216 72 72 0 
0 218 218 218 218 218 218 218 218 224 72 72 72 215 241 241 241 243 239 228 236 239 228 228 228 228 230 228 238 233 239 228 228 228 228 228 228 228 228 228 228 228 241 241 2 219 216 72 72 0 
0 72 72 72 72 72 72 72 72 72 72 72 72 215 219 241 243 239 228 228 235 232 232 232 232 232 234 228 228 228 228 228 228 228 228 228 228 228 228 228 228 2 241 241 241 219 216 72 72 0 
0 0 0 0 0 0 0 0 0 0 0 0 0 0 0 0 0 0 0 0 0 0 0 0 0 0 0 0 0 0 0 0 0 0 0 0 0 0 0 0 0 0 0 0 0 0 0 0 0 0 
