0 0 0 0 0 0 0 0 0 0 0 0 0 0 0 0 0 0 0 0 0 0 0 0 0 0 0 0 0 0 0 0 0 0 0 0 0 0 0 0 0 0 0 0 0 0 0 0 0 0 
0 0 0 0 0 0 0 0 0 0 0 0 0 0 0 0 0 0 0 0 0 0 0 0 0 0 0 0 0 0 0 0 0 0 0 0 0 0 0 0 0 0 0 0 0 0 0 0 0 0 
0 0 0 0 0 0 0 0 0 0 0 0 0 0 0 0 0 0 0 0 0 0 0 0 0 0 0 0 0 0 0 0 0 0 0 0 0 0 0 0 0 0 0 0 0 0 0 0 0 0 
0 0 0 0 0 0 0 0 0 0 0 0 0 0 0 0 0 0 0 0 0 0 0 0 0 0 0 0 0 0 0 0 0 0 0 0 0 0 0 0 0 0 0 0 0 0 0 0 0 0 
0 0 0 0 0 0 0 0 0 0 0 0 0 0 0 0 0 0 0 0 0 0 0 0 0 0 0 0 0 0 0 0 0 0 0 0 0 0 0 0 0 0 0 0 0 0 0 0 0 0 
0 0 0 0 0 0 0 0 0 0 0 0 0 0 0 0 0 0 0 0 0 0 0 0 0 0 0 0 0 0 0 0 0 0 0 0 0 0 0 0 0 0 0 0 0 0 0 0 0 0 
0 0 0 0 0 0 0 0 0 0 0 0 0 0 0 0 0 0 0 0 0 0 0 0 0 0 0 0 0 0 0 0 0 0 0 0 0 0 0 0 0 0 0 0 0 0 0 0 0 0 
0 0 0 0 0 0 0 0 0 0 0 0 0 0 0 0 0 0 0 0 0 0 0 0 0 0 0 0 0 0 0 0 0 0 0 0 0 0 0 0 0 0 0 0 0 0 0 0 0 0 
3 3 3 3 3 3 16 16 16 16 16 16 16 16 16 16 16 16 16 16 16 16 16 16 16 16 16 16 16 16 16 16 16 16 16 16 16 16 16 16 16 16 16 16 16 16 16 16 16 16 
3 3 3 64 3 3 16 16 16 16 16 16 16 16 16 16 16 16 16 16 16 16 16 16 16 16 16 16 16 16 16 16 16 16 16 16 16 16 16 16 16 16 16 16 16 16 16 16 16 16 
3 3 3 17 17 3 16 16 16 16 16 16 16 16 16 16 16 16 16 16 16 16 16 16 16 16 16 16 16 16 16 16 16 16 16 16 16 16 16 16 16 16 16 16 16 16 16 16 16 16 
3 3 3 3 64 17 16 16 16 16 16 16 16 16 16 16 16 16 16 16 16 16 16 16 16 16 16 16 16 16 16 16 16 16 16 16 16 16 16 16 16 16 16 16 16 16 16 16 16 16 
3 17 17 3 3 3 16 16 16 16 16 16 16 16 16 16 16 16 16 16 16 16 16 16 16 16 16 16 16 16 16 16 16 16 16 16 16 16 16 16 16 16 16 16 16 16 16 16 16 16 
3 3 17 17 3 3 16 16 16 16 16 16 16 16 16 16 16 16 16 16 16 16 16 16 16 16 16 16 16 16 16 16 16 16 16 16 16 16 16 16 16 16 16 16 16 16 16 16 16 16 
3 3 3 17 3 3 3 16 16 16 16 16 16 16 16 16 16 16 16 16 16 16 16 16 16 16 16 16 16 16 16 16 16 16 16 16 16 16 16 16 16 16 16 16 16 16 16 16 16 16 
3 3 63 3 3 3 3 16 32 32 32 32 32 32 32 32 32 32 32 32 32 32 32 32 32 32 32 32 32 32 32 32 32 32 32 32 32 32 32 32 16 16 16 16 16 16 16 16 16 16 
17 3 3 3 3 17 3 3 32 48 50 50 50 50 50 50 50 50 50 50 50 50 50 50 50 50 49 32 32 32 32 32 58 32 58 32 56 52 52 32 16 16 16 16 16 16 16 16 16 16
17 17 3 3 17 17 63 3 32 32 32 32 32 32 32 32 32 32 32 32 32 32 32 32 32 32 32 32 51 54 51 54 57 54 57 54 55 53 53 32 4 5 5 5 5 5 5 6 16 16 
3 17 17 3 3 3 3 3 32 46 46 46 34 34 34 34 35 35 45 35 34 34 34 34 34 34 34 32 34 34 34 34 34 34 34 34 34 34 34 32 7 2 2 2 16 16 16 8 16 16 
3 63 3 3 3 3 3 3 32 46 34 34 34 34 34 34 34 34 34 34 34 34 44 44 44 44 34 32 34 34 34 34 34 34 34 34 44 44 34 32 7 2 1 2 2 16 16 8 16 16 
3 3 3 3 3 17 17 17 32 46 34 34 34 34 34 34 34 34 43 43 43 34 35 35 35 35 34 32 34 34 34 34 34 34 34 34 35 35 34 32 7 2 2 2 2 16 16 8 16 16 
3 17 64 3 3 63 3 17 32 46 34 34 34 34 34 34 34 34 34 34 34 34 34 34 34 34 34 32 34 34 34 34 34 34 34 34 34 34 34 32 7 2 2 15 16 12 16 8 16 16 
17 17 3 3 3 3 17 3 32 46 46 46 34 34 34 34 34 34 34 47 34 34 34 34 34 34 34 34 34 34 34 34 34 34 34 34 34 34 34 32 7 14 2 16 1 2 16 8 16 16
3 3 3 3 17 17 3 3 32 32 32 32 32 34 34 34 32 32 32 32 32 32 32 32 32 32 32 32 32 32 32 32 32 32 32 32 34 34 32 32 7 1 2 2 2 2 16 8 16 16 
3 3 63 3 3 17 17 64 42 34 34 34 34 34 34 34 34 34 34 34 34 34 34 34 34 34 34 34 34 34 34 34 34 34 34 34 34 34 34 61 7 2 16 2 2 2 16 8 16 16 
3 3 3 3 3 3 17 64 42 34 34 34 34 34 34 34 34 34 34 34 34 34 34 34 34 34 34 34 34 34 34 34 34 34 34 34 34 34 34 62 7 2 15 2 12 2 16 8 16 16 
3 3 3 3 3 3 3 3 32 32 32 32 32 32 32 32 32 32 59 60 32 32 32 32 32 32 32 32 32 41 40 32 32 32 32 32 32 32 32 32 7 2 16 2 2 2 16 8 16 16 
17 17 3 3 17 3 63 3 32 46 46 46 46 34 34 34 34 34 34 34 34 61 34 34 34 34 35 35 32 0 0 0 0 0 0 0 0 0 0 32 7 2 2 2 1 2 2 8 16 16 
3 3 3 3 3 17 3 3 32 46 46 46 46 34 34 34 34 34 34 34 34 32 34 34 34 34 34 34 32 0 0 0 0 0 0 0 0 0 0 32 7 2 1 2 2 15 2 8 16 16 
3 3 3 3 64 3 3 3 32 34 34 34 34 34 34 34 34 34 34 34 34 32 34 34 34 34 44 44 32 0 0 0 0 0 0 0 0 0 0 32 7 2 16 2 2 2 2 8 16 16 
3 3 3 3 3 3 3 3 32 34 34 34 34 34 34 34 34 34 34 34 34 32 32 32 32 32 32 32 32 0 0 0 0 0 0 0 0 0 0 32 7 2 2 12 2 1 1 8 16 16 
17 3 3 63 3 3 3 3 32 38 39 39 34 34 34 34 34 34 34 34 34 32 0 0 0 0 0 0 32 0 0 0 0 0 0 0 0 0 0 32 7 2 1 2 2 2 16 8 16 16 
3 3 3 3 3 17 3 3 32 38 39 39 34 34 34 34 34 34 34 34 34 32 0 0 0 0 0 0 32 0 0 0 0 0 0 0 0 0 0 32 7 2 2 2 2 2 2 8 16 16 
3 17 3 3 3 17 17 3 32 34 34 34 34 34 34 34 34 34 34 44 44 32 0 0 0 0 0 0 0 0 0 0 0 0 0 0 0 0 0 32 7 2 15 2 1 2 1 8 16 16 
3 3 3 3 3 3 17 3 32 32 32 32 32 32 32 32 32 32 32 32 32 32 32 32 32 32 32 32 32 32 32 32 32 32 32 32 32 32 32 32 7 2 2 2 16 2 2 8 16 16 
3 63 3 3 3 3 3 63 3 3 4 5 5 5 5 5 5 5 5 5 5 5 5 5 5 5 5 5 5 5 5 5 5 5 5 5 5 5 5 5 15 2 2 2 2 2 2 8 16 16 
3 3 17 17 17 64 3 3 3 3 7 2 1 1 2 1 1 1 1 2 2 16 2 2 2 16 2 1 2 2 2 16 2 1 16 2 2 2 2 1 2 2 2 12 2 2 2 8 16 16 
3 3 3 17 17 3 3 3 3 3 7 1 1 1 16 2 1 1 1 16 2 2 2 1 16 2 2 2 2 2 2 12 2 2 2 16 1 1 2 2 1 16 16 2 2 2 2 8 16 16 
3 3 3 17 3 3 3 3 3 3 7 1 2 1 1 1 1 16 1 1 1 3 2 16 2 2 1 16 2 2 1 2 2 16 2 2 2 2 2 2 16 16 2 2 2 2 16 8 16 16 
3 3 3 3 3 3 64 3 3 3 9 10 10 10 10 10 10 10 10 10 10 10 10 10 10 10 10 10 10 10 10 10 10 10 10 10 10 10 10 10 10 10 10 10 10 10 10 11 16 16 
17 3 3 63 3 17 17 3 16 16 16 16 16 16 16 16 16 16 16 16 16 16 16 16 16 16 16 16 16 16 16 16 16 16 16 16 16 16 16 16 16 16 16 16 16 16 16 16 16 16 
64 17 3 3 3 17 3 16 16 16 16 16 16 16 16 16 16 16 16 16 16 16 16 16 16 16 16 16 16 16 16 16 16 16 16 16 16 16 16 16 16 16 16 16 16 16 16 16 16 16 
3 17 3 3 3 3 16 16 16 16 16 16 16 16 16 16 16 16 16 16 16 16 16 16 16 16 16 16 16 16 16 16 16 16 16 16 16 16 16 16 16 16 16 16 16 16 16 16 16 16 
3 3 3 3 3 3 16 16 16 16 16 16 16 16 16 16 16 16 16 16 16 16 16 16 16 16 16 16 16 16 16 16 16 16 16 16 16 16 16 16 16 16 16 16 16 16 16 16 16 16 
3 63 3 3 3 3 16 16 16 16 16 16 16 16 16 16 16 16 16 16 16 16 16 16 16 16 16 16 16 16 16 16 16 16 16 16 16 16 16 16 16 16 16 16 16 16 16 16 16 16 
3 3 3 3 3 3 16 16 16 16 16 16 16 16 16 16 16 16 16 16 16 16 16 16 16 16 16 16 16 16 16 16 16 16 16 16 16 16 16 16 16 16 16 16 16 16 16 16 16 16 
3 3 17 17 63 3 16 16 16 16 16 16 16 16 16 16 16 16 16 16 16 16 16 16 16 16 16 16 16 16 16 16 16 16 16 16 16 16 16 16 16 16 16 16 16 16 16 16 16 16 
3 3 3 17 17 3 16 16 16 16 16 16 16 16 16 16 16 16 16 16 16 16 16 16 16 16 16 16 16 16 16 16 16 16 16 16 16 16 16 16 16 16 16 16 16 16 16 16 16 16 
3 3 3 3 3 3 16 16 16 16 16 16 16 16 16 16 16 16 16 16 16 16 16 16 16 16 16 16 16 16 16 16 16 16 16 16 16 16 16 16 16 16 16 16 16 16 16 16 16 16 
3 3 3 3 3 3 0 0 0 0 0 0 0 0 0 0 0 0 0 0 0 0 0 0 0 0 0 0 0 0 0 0 0 0 0 0 0 0 0 0 0 0 0 0 0 0 0 0 0 0 
