0 0 0 0 0 0 0 0 0 0 0 0 0 0 0 0 0 0 0 0 0 0 0 0 0 0 0 0 0 0 0 0 0 0 0 0 0 0 0 0 0 0 0 0 0 0 0 0 0 0 
0 0 0 0 0 0 0 0 0 0 0 0 0 0 0 0 0 0 0 0 0 0 0 0 0 0 0 0 0 0 0 0 0 0 0 0 0 0 0 0 0 0 0 0 0 0 0 0 0 0 
0 0 0 0 0 0 0 0 0 0 0 0 0 0 0 0 0 0 0 0 0 0 0 0 0 0 0 0 0 0 0 0 0 0 0 0 0 0 0 0 0 0 0 0 0 0 0 0 0 0 
0 0 0 0 0 0 0 0 0 0 0 0 0 0 0 0 0 0 0 0 0 0 0 0 0 0 0 0 0 0 0 0 0 0 0 0 0 0 0 0 0 0 0 0 0 0 0 0 0 0 
0 0 0 0 0 0 0 0 0 0 0 0 0 0 0 0 0 0 0 0 0 0 0 0 0 0 0 0 0 0 0 0 0 0 0 0 0 0 0 0 0 0 0 0 0 0 0 0 0 0 
0 0 0 0 0 0 0 0 0 0 0 0 0 0 0 0 0 0 0 0 0 0 0 0 0 0 0 0 0 0 0 0 0 0 0 0 0 0 0 0 0 0 0 0 0 0 0 0 0 0 
0 0 0 0 0 0 0 0 0 0 0 0 0 0 0 0 0 0 0 0 0 0 0 0 0 0 0 0 0 0 0 0 0 0 0 0 0 0 0 0 0 0 0 0 0 0 0 0 0 0 
0 0 0 0 0 0 0 0 0 0 0 0 0 0 0 0 0 0 0 0 0 0 0 0 0 0 0 0 0 0 0 0 0 0 0 0 0 0 0 0 0 0 0 0 0 0 0 0 0 0 
0 0 0 0 0 0 0 0 0 0 0 0 0 0 0 0 0 0 0 0 0 0 0 0 0 0 0 0 0 0 0 0 0 0 0 0 0 0 0 0 0 0 0 0 0 0 0 0 0 0 
0 0 0 0 0 0 0 0 132 132 132 132 132 132 132 132 132 132 132 132 132 132 132 132 132 132 132 132 132 132 132 132 132 132 132 132 132 132 132 132 132 132 0 0 0 0 0 0 0 0 
0 0 0 0 0 0 0 0 132 132 132 132 132 132 132 132 52 132 52 132 132 132 132 132 132 132 132 132 132 132 132 132 132 132 132 132 132 132 132 132 132 132 0 0 0 0 0 0 0 0 
0 0 0 0 0 0 0 0 132 132 132 133 132 132 132 132 53 54 53 132 132 132 132 132 132 132 132 132 132 132 132 132 132 132 132 132 132 132 132 132 132 132 0 0 0 0 0 0 0 0 
0 0 0 0 0 0 0 0 130 129 131 48 118 59 118 120 46 48 47 33 132 0 0 0 0 0 0 0 0 132 0 0 0 0 0 0 0 0 0 0 0 132 0 0 0 0 0 0 0 0 
0 0 0 0 0 0 0 0 127 123 128 120 145 147 147 147 147 147 136 118 132 0 0 0 0 0 0 0 0 132 0 0 0 0 0 0 0 0 0 0 0 132 0 0 0 0 0 0 0 0 
0 0 0 0 0 0 0 0 126 124 125 118 138 143 146 146 146 144 137 118 132 0 0 0 0 0 0 0 0 132 0 0 0 0 0 0 0 0 0 0 0 132 0 0 0 0 0 0 0 0 
0 0 0 0 0 0 0 0 122 121 118 118 138 146 146 142 146 146 137 118 132 0 0 0 0 0 0 0 0 132 0 0 0 0 0 0 0 0 0 0 0 132 0 0 0 0 0 0 0 0 
0 0 0 0 0 0 0 0 118 118 120 118 139 141 141 141 141 141 140 118 132 0 0 0 0 0 0 0 0 132 0 0 0 0 0 0 0 0 0 0 0 132 0 0 0 0 0 0 0 0 
0 0 0 0 0 0 0 0 60 118 33 118 32 121 121 121 118 118 118 118 132 0 0 0 0 0 0 0 0 132 0 0 0 0 0 0 0 0 0 0 0 132 0 0 0 0 0 0 0 0 
0 0 0 0 0 0 0 0 132 132 132 132 132 132 132 132 132 132 118 118 132 0 0 0 0 0 0 0 0 132 0 0 0 0 0 0 0 0 0 0 0 132 0 0 0 0 0 0 0 0 
0 0 0 0 0 0 0 0 132 132 132 132 132 132 132 132 132 132 118 118 132 132 0 0 132 132 132 132 132 132 132 132 132 132 132 132 0 0 132 132 132 132 0 0 0 0 0 0 0 0 
0 0 0 0 0 0 0 0 132 132 132 44 44 45 132 132 132 132 118 118 132 132 0 0 132 132 132 132 132 52 54 57 132 132 132 132 0 0 132 132 132 132 0 0 0 0 0 0 0 0 
0 0 0 0 0 0 0 0 132 132 132 43 133 71 132 132 132 132 118 118 132 132 41 40 132 132 132 132 132 53 54 57 55 132 132 132 41 40 132 132 132 132 0 0 0 0 0 0 0 0 
0 0 0 0 0 0 0 0 33 118 118 46 48 47 6 120 118 118 67 67 118 118 67 33 118 118 6 118 118 48 48 48 48 118 118 118 33 67 118 118 118 122 0 0 0 0 0 0 0 0 
0 0 0 0 0 0 0 0 17 121 122 118 6 118 120 118 118 118 120 118 118 118 118 118 118 118 118 118 118 118 6 118 118 118 118 118 118 118 118 118 122 118 0 0 0 0 0 0 0 0 
0 0 0 0 0 0 0 0 118 118 121 61 118 61 6 118 33 132 118 6 132 132 132 132 132 132 132 132 132 132 132 132 132 118 118 6 132 132 132 132 132 132 0 0 0 0 0 0 0 0 
0 0 0 0 0 0 0 0 120 118 49 37 39 69 50 118 118 132 6 120 132 132 132 132 52 54 54 132 132 132 132 132 132 118 118 118 132 132 132 132 132 132 0 0 0 0 0 0 0 0 
0 0 0 0 0 0 0 0 118 17 118 35 36 68 50 118 118 132 2 118 132 132 132 132 53 54 54 132 132 132 132 132 132 118 118 118 132 133 132 132 132 132 0 0 0 0 0 0 0 0 
0 0 0 0 0 0 0 0 118 118 56 118 118 121 118 118 62 132 120 118 132 118 121 33 48 48 48 33 33 33 33 118 118 118 118 118 135 48 33 130 129 131 0 0 0 0 0 0 0 0 
0 0 0 0 0 0 0 0 121 6 120 118 17 121 118 118 118 132 118 120 132 33 33 61 118 6 118 118 2 17 118 118 118 17 6 118 135 17 33 127 123 128 0 0 0 0 0 0 0 0 
0 0 0 0 0 0 0 0 118 118 17 17 118 118 33 118 118 132 6 118 132 49 37 38 118 118 121 118 17 6 118 33 118 118 118 118 135 33 6 126 124 125 0 0 0 0 0 0 0 0 
0 0 0 0 0 0 0 0 33 118 118 118 122 118 118 118 33 132 118 118 132 118 70 68 50 118 118 118 121 118 118 118 118 33 118 118 118 118 145 147 136 122 0 0 0 0 0 0 0 0 
0 0 0 0 0 0 0 0 118 33 33 60 118 118 118 33 121 132 118 6 132 56 118 118 122 118 118 118 118 118 118 6 118 118 118 118 6 118 139 141 140 122 0 0 0 0 0 0 0 0 
0 0 0 0 0 0 0 0 60 118 118 33 118 118 118 33 122 132 67 67 132 33 118 118 118 121 121 118 62 118 118 118 118 118 33 33 135 59 118 118 33 33 0 0 0 0 0 0 0 0 
0 0 0 0 0 0 0 0 0 0 0 0 0 0 0 0 0 0 0 0 0 0 0 0 0 0 0 0 0 0 0 0 0 0 0 0 0 0 0 0 0 0 0 0 0 0 0 0 0 0 
0 0 0 0 0 0 0 0 0 0 0 0 0 0 0 0 0 0 0 0 0 0 0 0 0 0 0 0 0 0 0 0 0 0 0 0 0 0 0 0 0 0 0 0 0 0 0 0 0 0 
0 0 0 0 0 0 0 0 0 0 0 0 0 0 0 0 0 0 0 0 0 0 0 0 0 0 0 0 0 0 0 0 0 0 0 0 0 0 0 0 0 0 0 0 0 0 0 0 0 0 
0 0 0 0 0 0 0 0 0 0 0 0 0 0 0 0 0 0 0 0 0 0 0 0 0 0 0 0 0 0 0 0 0 0 0 0 0 0 0 0 0 0 0 0 0 0 0 0 0 0 
0 0 0 0 0 0 0 0 0 0 0 0 0 0 0 0 0 0 0 0 0 0 0 0 0 0 0 0 0 0 0 0 0 0 0 0 0 0 0 0 0 0 0 0 0 0 0 0 0 0 
0 0 0 0 0 0 0 0 0 0 0 0 0 0 0 0 0 0 0 0 0 0 0 0 0 0 0 0 0 0 0 0 0 0 0 0 0 0 0 0 0 0 0 0 0 0 0 0 0 0 
0 0 0 0 0 0 0 0 0 0 0 0 0 0 0 0 0 0 0 0 0 0 0 0 0 0 0 0 0 0 0 0 0 0 0 0 0 0 0 0 0 0 0 0 0 0 0 0 0 0 
0 0 0 0 0 0 0 0 0 0 0 0 0 0 0 0 0 0 0 0 0 0 0 0 0 0 0 0 0 0 0 0 0 0 0 0 0 0 0 0 0 0 0 0 0 0 0 0 0 0 
0 0 0 0 0 0 0 0 0 0 0 0 0 0 0 0 0 0 0 0 0 0 0 0 0 0 0 0 0 0 0 0 0 0 0 0 0 0 0 0 0 0 0 0 0 0 0 0 0 0 
0 0 0 0 0 0 0 0 0 0 0 0 0 0 0 0 0 0 0 0 0 0 0 0 0 0 0 0 0 0 0 0 0 0 0 0 0 0 0 0 0 0 0 0 0 0 0 0 0 0 
0 0 0 0 0 0 0 0 0 0 0 0 0 0 0 0 0 0 0 0 0 0 0 0 0 0 0 0 0 0 0 0 0 0 0 0 0 0 0 0 0 0 0 0 0 0 0 0 0 0 
0 0 0 0 0 0 0 0 0 0 0 0 0 0 0 0 0 0 0 0 0 0 0 0 0 0 0 0 0 0 0 0 0 0 0 0 0 0 0 0 0 0 0 0 0 0 0 0 0 0 
0 0 0 0 0 0 0 0 0 0 0 0 0 0 0 0 0 0 0 0 0 0 0 0 0 0 0 0 0 0 0 0 0 0 0 0 0 0 0 0 0 0 0 0 0 0 0 0 0 0 
0 0 0 0 0 0 0 0 0 0 0 0 0 0 0 0 0 0 0 0 0 0 0 0 0 0 0 0 0 0 0 0 0 0 0 0 0 0 0 0 0 0 0 0 0 0 0 0 0 0 
0 0 0 0 0 0 0 0 0 0 0 0 0 0 0 0 0 0 0 0 0 0 0 0 0 0 0 0 0 0 0 0 0 0 0 0 0 0 0 0 0 0 0 0 0 0 0 0 0 0 
0 0 0 0 0 0 0 0 0 0 0 0 0 0 0 0 0 0 0 0 0 0 0 0 0 0 0 0 0 0 0 0 0 0 0 0 0 0 0 0 0 0 0 0 0 0 0 0 0 0 
0 0 0 0 0 0 0 0 0 0 0 0 0 0 0 0 0 0 0 0 0 0 0 0 0 0 0 0 0 0 0 0 0 0 0 0 0 0 0 0 0 0 0 0 0 0 0 0 0 0 
