0 0 0 0 0 0 0 0 0 0 0 0 0 0 0 0 0 0 0 0 0 0 0 0 0 0 0 0 0 0 0 0 0 0 0 0 0 0 0 0 0 0 0 0 0 0 0 0 0 0 
0 158 165 155 155 155 155 155 223 154 155 155 155 155 155 65 155 155 65 155 65 155 155 155 155 155 155 155 155 155 153 148 148 148 160 157 158 158 158 158 158 158 158 158 158 158 165 223 155 0 
0 218 157 165 155 65 155 155 157 156 155 155 164 158 158 158 158 158 158 158 158 158 158 158 158 158 158 158 158 158 156 160 160 160 17 66 218 218 218 218 218 218 218 218 218 2 151 157 158 0 
0 72 218 157 165 164 158 158 158 158 158 158 156 219 218 218 218 218 218 218 2 17 17 17 17 17 17 17 17 17 17 17 17 17 17 216 72 72 72 72 72 72 72 72 72 215 157 158 158 0 
0 72 72 218 157 156 218 218 218 218 218 218 218 224 72 72 72 72 72 72 215 92 84 84 84 84 111 17 17 17 17 92 111 17 17 216 72 72 72 72 72 72 72 72 72 227 218 218 218 0 
0 72 72 72 218 218 72 72 72 72 72 72 72 72 72 72 72 72 72 72 215 87 2 2 2 2 91 17 17 82 17 112 113 17 17 216 72 72 72 72 72 72 72 72 72 72 72 72 72 0 
0 72 72 72 72 72 72 72 180 179 179 179 179 179 181 72 72 72 72 72 215 87 2 219 2 2 91 17 17 17 17 81 17 81 17 216 72 72 72 72 72 72 72 72 72 72 72 72 72 0 
0 72 72 72 72 72 72 72 182 184 184 184 184 184 183 72 72 72 72 72 215 87 2 2 2 90 113 17 17 81 17 17 82 17 17 216 72 72 72 72 72 72 72 72 72 72 72 72 72 0 
0 72 72 72 72 72 72 72 182 184 184 184 184 184 183 72 72 72 72 72 215 112 89 89 89 113 17 17 82 82 82 81 17 17 17 216 72 72 72 72 72 72 72 72 72 72 72 72 72 0 
0 72 72 72 72 226 217 217 178 176 176 176 176 176 177 217 217 217 217 217 66 114 114 115 115 17 81 81 81 81 17 17 17 17 17 2 217 217 217 217 217 217 217 217 225 72 72 72 72 0 
0 72 72 72 72 215 17 17 17 17 17 175 17 17 114 17 17 17 17 17 17 17 82 17 17 17 17 17 17 92 84 84 111 17 17 17 17 17 17 17 17 17 17 17 216 72 72 72 72 0 
0 72 72 72 72 215 17 17 17 17 17 175 17 114 115 17 17 17 82 17 17 17 17 82 82 82 92 84 84 86 90 88 91 17 82 17 17 17 17 17 17 115 114 17 216 72 72 72 72 0 
0 72 72 72 72 215 17 17 17 17 17 175 17 115 17 17 82 17 82 82 17 17 81 81 81 17 87 90 89 89 113 87 91 17 17 17 17 17 17 17 115 114 17 17 216 72 72 72 72 0 
0 72 72 72 72 215 17 17 17 17 17 175 17 114 17 17 114 17 17 17 17 82 82 82 17 17 87 91 66 66 92 86 91 17 17 17 17 82 17 82 17 17 17 17 216 72 72 72 72 0 
0 72 72 72 72 215 17 17 17 92 111 174 17 114 17 17 17 17 17 17 17 17 17 17 17 17 87 83 84 84 86 90 113 17 17 17 17 17 17 82 82 17 17 114 216 72 72 72 72 0 
0 72 72 72 72 215 17 132 132 132 132 132 132 132 132 132 132 132 132 132 132 132 132 132 132 17 132 132 132 132 132 132 132 132 132 132 132 132 132 132 132 132 132 114 216 72 72 72 72 0 
0 72 72 72 72 215 17 0 0 0 0 0 0 0 0 0 0 0 0 0 173 173 173 52 52 17 173 173 52 173 173 1 52 52 1 1 1 54 54 1 1 1 1 17 216 72 72 72 72 0 
0 72 72 72 72 215 114 0 0 51 54 51 0 0 0 0 57 0 0 0 173 173 173 53 53 17 173 173 53 173 173 1 53 53 1 1 1 54 54 1 1 1 1 17 216 72 72 72 72 0 
0 72 72 72 72 215 17 0 188 190 190 190 172 171 172 171 190 149 149 0 173 185 171 190 190 172 172 17 190 171 173 1 190 190 149 17 149 190 190 171 17 149 1 17 216 72 72 72 72 0 
0 72 72 72 72 215 17 0 188 171 172 172 185 172 17 149 172 171 149 0 173 185 172 171 185 172 171 185 171 172 173 173 171 149 185 171 172 17 185 172 17 185 1 17 216 72 72 72 72 0 
0 72 72 72 72 215 17 0 188 172 191 171 185 149 17 185 185 172 172 17 173 188 172 172 185 171 172 171 17 66 66 17 17 17 172 185 171 172 185 149 172 171 1 17 216 72 72 72 72 0 
0 72 72 72 72 215 17 0 185 171 172 185 172 149 149 185 172 171 186 172 172 172 172 17 185 172 172 17 17 186 66 1 17 17 172 172 185 185 149 149 185 185 1 17 216 72 72 72 72 0 
0 72 72 72 72 215 17 0 172 149 149 172 185 172 172 185 172 171 186 0 173 188 171 185 172 172 171 172 17 66 173 1 172 185 185 171 171 17 185 17 172 17 1 17 216 72 72 72 72 0 
0 72 72 72 72 215 17 0 172 185 149 17 172 185 191 172 185 186 186 0 173 185 172 171 172 192 188 191 185 171 173 1 17 171 149 149 185 171 185 185 149 171 1 17 216 72 72 72 72 0 
0 72 72 72 72 215 2 0 0 0 0 17 17 0 0 0 0 0 0 0 173 173 173 173 173 173 173 173 173 173 173 1 1 1 1 1 1 172 191 1 192 17 1 17 216 72 72 72 72 0 
0 72 72 72 72 215 17 18 57 57 57 171 18 18 18 132 132 132 132 132 132 132 132 133 132 132 132 132 132 132 132 132 132 132 132 132 34 172 191 34 172 171 34 17 216 72 72 72 72 0 
0 72 72 72 72 215 17 18 190 190 190 172 17 172 18 185 17 185 17 17 2 2 17 190 172 172 2 2 92 84 84 84 84 84 111 132 34 172 149 34 172 172 34 17 216 72 72 72 72 0 
0 72 72 72 72 215 2 18 149 185 172 171 172 172 18 17 185 17 17 2 172 17 172 172 4 185 172 2 87 20 21 21 21 22 91 132 34 149 172 34 17 149 34 17 216 72 72 72 72 0 
0 72 72 72 72 215 2 18 172 149 171 172 149 172 18 185 17 17 2 172 188 172 172 172 17 172 4 17 87 23 28 29 19 24 91 132 34 149 172 34 172 149 34 17 216 72 72 72 72 0 
0 72 72 72 72 215 2 18 172 185 172 172 171 185 18 185 17 17 172 172 149 149 172 4 172 149 172 185 87 23 30 31 19 24 91 132 34 17 172 34 149 17 34 17 216 72 72 72 72 0 
0 72 72 72 72 215 2 18 172 17 172 17 185 172 18 171 171 17 172 172 17 172 192 172 172 185 171 171 87 25 26 26 26 27 91 132 34 171 171 34 172 17 34 17 216 72 72 72 72 0 
0 72 72 72 72 215 2 18 185 172 185 185 172 149 18 17 172 172 172 171 172 149 149 192 4 4 171 172 112 89 89 89 89 89 113 132 34 171 2 34 172 172 34 17 216 72 72 72 72 0 
0 72 72 72 72 215 2 18 185 172 171 171 185 172 18 185 172 149 17 172 172 172 171 4 4 4 4 192 172 172 17 17 172 172 172 132 34 172 172 102 172 149 102 17 216 72 72 72 72 0 
0 72 72 72 72 215 2 18 185 172 185 185 172 17 18 185 172 149 171 4 172 172 4 4 149 149 4 4 172 172 185 172 17 172 172 132 34 2 172 102 17 172 102 17 216 72 72 72 72 0 
0 72 72 72 72 215 2 18 172 149 171 171 149 172 17 172 172 172 172 171 17 172 171 4 4 17 4 149 171 171 172 185 172 172 186 132 34 172 17 102 17 171 102 17 216 72 72 72 72 0 
0 72 72 72 72 215 2 18 17 172 171 172 172 186 17 191 191 17 149 172 172 149 149 172 4 4 17 17 172 172 4 172 172 2 186 132 34 172 17 102 172 171 102 17 216 72 72 72 72 0 
0 72 72 72 72 215 2 18 188 17 149 171 172 186 18 17 171 17 191 171 172 172 172 17 172 172 17 149 172 172 172 172 172 17 186 132 34 2 172 102 172 172 102 17 216 72 72 72 72 0 
0 72 72 72 72 215 2 18 191 17 17 172 172 186 18 185 172 172 172 172 191 172 17 172 172 171 172 149 172 172 172 171 2 17 186 132 34 172 172 102 171 2 102 17 216 72 72 72 72 0 
0 72 72 72 72 215 2 18 18 18 18 18 18 18 18 132 132 172 132 132 132 132 132 132 132 132 132 132 132 132 132 132 132 132 132 132 34 172 2 102 172 149 102 17 216 72 72 72 72 0 
0 72 72 72 72 215 17 34 34 34 34 34 34 34 34 34 34 172 34 34 34 34 34 34 34 34 34 34 34 34 34 34 34 34 34 34 34 172 172 102 149 2 102 17 216 72 72 72 72 0 
0 72 72 72 72 215 17 34 188 172 172 172 172 172 172 172 172 172 34 34 34 34 188 172 172 172 2 172 172 172 172 2 172 172 172 172 17 172 2 102 172 149 102 17 216 72 72 72 72 0 
0 72 72 72 72 215 2 34 188 172 172 172 185 149 149 172 172 186 188 185 172 172 172 172 172 17 17 17 172 2 2 2 172 17 172 172 172 2 2 102 2 2 102 17 216 72 72 72 72 0 
0 72 72 72 72 215 2 34 172 172 185 149 172 185 185 185 185 149 185 185 172 186 102 102 102 102 102 102 102 102 102 102 102 102 102 102 102 102 102 102 2 17 102 17 216 72 72 72 72 0 
0 72 72 72 72 215 2 34 172 172 185 185 172 172 172 149 149 172 185 172 149 186 102 172 172 192 172 172 149 172 172 172 172 191 172 172 172 172 172 172 2 172 102 17 216 72 72 72 72 0 
0 72 72 72 72 215 2 34 172 172 172 188 172 172 172 186 172 172 185 149 149 186 102 2 171 149 172 172 171 149 172 17 172 149 17 17 171 171 192 171 191 2 102 17 216 72 72 72 72 0 
0 72 72 72 72 215 17 34 172 185 185 185 185 185 172 186 149 172 172 149 172 186 102 2 171 171 149 149 172 149 2 171 171 172 17 172 149 172 149 171 149 2 102 17 216 72 72 72 72 0 
0 72 72 72 72 215 2 102 149 149 172 149 172 172 185 186 149 149 172 172 185 186 102 2 149 171 2 102 172 172 172 149 171 149 192 172 172 191 172 172 172 192 102 17 216 72 72 72 72 0 
0 72 72 72 72 215 17 102 102 102 102 102 102 102 102 102 102 102 102 102 102 102 102 2 17 2 172 102 102 102 102 102 102 102 102 102 102 102 102 102 102 102 102 17 216 72 72 72 72 0 
0 72 72 72 72 215 17 2 17 2 2 2 2 17 17 17 17 17 2 2 2 2 2 203 203 203 203 2 2 2 17 17 2 2 2 2 2 2 2 2 2 2 17 17 216 72 72 72 72 0 
0 0 0 0 0 0 0 0 0 0 0 0 0 0 0 0 0 0 0 0 0 0 0 0 0 0 0 0 0 0 0 0 0 0 0 0 0 0 0 0 0 0 0 0 0 0 0 0 0 0 
