0 0 0 0 0 0 0 0 0 0 0 0 0 0 0 0 0 0 0 0 0 0 0 0 0 0 0 0 0 0 0 0 0 0 0 0 0 0 0 0 0 0 0 0 0 0 0 0 0 0 
0 72 72 72 72 72 72 72 72 72 72 72 72 72 72 72 72 72 72 72 72 72 72 72 72 72 72 72 72 72 72 72 72 72 72 72 72 72 72 72 72 72 72 72 72 72 72 72 72 0 
0 72 72 72 72 72 72 72 72 72 72 72 72 72 72 72 72 72 72 72 72 72 72 72 72 72 72 72 72 72 72 72 72 72 72 72 72 72 72 72 72 72 72 72 72 72 72 72 72 0 
0 72 72 72 72 72 72 72 72 72 72 72 72 72 72 72 72 72 72 72 72 72 72 72 72 72 72 72 72 72 72 72 72 72 72 72 72 72 72 72 72 72 72 72 72 72 72 72 72 0 
0 72 72 72 72 72 72 72 72 72 72 72 72 72 72 72 72 72 72 72 72 72 72 72 72 72 72 72 72 72 72 72 72 72 72 72 72 72 72 72 72 72 72 72 72 72 72 72 72 0 
0 72 72 72 72 77 73 73 73 73 73 73 73 73 73 73 73 73 73 73 73 73 73 73 73 73 73 73 73 73 73 73 73 73 73 73 73 73 73 73 73 73 73 73 78 72 72 72 72 0 
0 72 72 72 72 74 114 114 115 114 115 17 17 17 17 17 17 17 85 17 66 66 66 17 17 17 17 17 17 17 17 17 17 17 66 17 17 17 17 114 115 115 114 17 79 72 72 72 72 0 
0 72 72 72 72 74 92 84 84 84 84 84 84 84 84 84 84 84 84 84 84 84 84 111 114 92 84 84 84 84 84 84 84 84 84 84 84 84 84 84 84 84 111 17 79 72 72 72 72 0 
0 72 72 72 72 74 87 117 102 102 102 102 102 102 102 103 2 2 2 2 2 2 2 91 115 87 2 2 2 2 2 2 2 2 2 2 2 2 2 2 2 2 91 85 79 72 72 72 72 0 
0 72 72 72 72 74 87 117 102 102 102 102 102 102 102 103 2 5 2 2 2 2 2 91 114 87 117 102 102 102 102 102 102 102 102 102 102 102 102 102 103 2 91 17 79 72 72 72 72 0 
0 72 72 72 72 74 87 116 100 100 100 100 100 100 100 104 2 2 2 2 2 2 2 91 17 87 117 102 102 102 102 102 102 102 102 102 102 102 102 102 103 2 91 17 79 72 72 72 72 0 
0 72 72 72 72 74 87 2 108 98 99 97 98 99 109 2 2 2 2 2 2 2 2 91 17 87 117 102 102 102 102 102 102 102 102 102 102 102 102 102 103 2 91 115 79 72 72 72 72 0 
0 72 72 72 72 74 87 2 93 105 94 96 105 105 106 2 110 2 2 2 2 2 2 91 17 87 116 100 100 100 100 100 100 100 100 100 100 100 100 100 104 2 91 66 79 72 72 72 72 0 
0 72 72 72 72 74 87 2 2 2 2 2 2 2 2 2 2 2 2 2 2 5 2 91 17 87 2 108 107 97 97 97 97 97 97 97 97 97 107 109 2 2 91 17 79 72 72 72 72 0 
0 72 72 72 72 74 87 2 2 2 2 2 2 2 2 2 2 20 22 2 2 2 2 91 66 87 2 108 97 97 107 97 97 97 97 97 97 97 97 109 2 2 91 17 79 72 72 72 72 0 
0 72 72 72 72 74 87 2 5 2 2 2 2 2 2 2 20 31 30 21 22 2 2 91 114 87 2 108 98 99 107 98 99 97 98 99 107 98 99 109 2 2 91 114 79 72 72 72 72 0 
0 72 72 72 72 74 87 2 2 2 2 2 2 2 2 2 25 26 26 26 27 2 2 91 81 87 2 93 94 105 105 105 94 96 94 105 94 105 105 95 2 2 91 115 79 72 72 72 72 0 
0 72 72 72 72 74 87 2 2 2 2 2 2 2 2 2 2 2 2 2 2 2 2 91 82 112 89 89 89 89 89 89 66 66 66 89 89 89 89 89 89 89 113 17 79 72 72 72 72 0 
0 72 72 72 72 74 112 89 89 89 89 89 89 89 89 89 89 89 89 89 89 89 89 113 82 82 114 92 84 84 84 84 84 84 84 84 84 84 84 84 84 84 84 111 79 72 72 72 72 0 
0 72 72 72 72 74 17 17 114 115 17 17 66 17 17 66 17 17 17 17 17 17 17 17 114 17 17 87 2 2 2 2 2 2 2 2 2 2 2 2 2 2 2 91 79 72 72 72 72 0 
0 72 72 72 72 74 17 114 115 114 17 17 17 17 17 92 84 84 84 84 84 84 84 84 111 17 17 112 88 2 2 2 2 2 2 2 2 2 2 2 2 2 2 91 79 72 72 72 72 0 
0 72 72 72 72 74 114 115 114 17 17 17 17 17 17 87 20 21 21 21 21 21 21 22 83 111 17 17 112 89 89 89 88 2 90 89 89 89 88 2 2 2 90 113 79 72 72 72 72 0 
0 72 72 72 72 74 17 85 132 132 132 17 17 17 17 87 23 18 18 18 18 18 18 30 22 83 84 84 84 84 111 17 87 2 91 114 114 115 87 2 2 90 113 17 79 72 72 72 72 0 
0 72 72 72 72 74 17 132 51 132 132 132 17 17 17 87 23 19 18 19 19 18 18 18 30 21 21 21 21 22 91 17 87 2 91 17 17 92 86 2 90 113 115 114 79 72 72 72 72 0 
0 72 72 72 72 74 132 132 48 121 17 118 17 17 17 87 23 18 18 18 18 19 18 18 18 18 18 18 19 24 91 17 87 2 83 84 84 86 2 2 91 17 114 114 79 72 72 72 72 0 
0 72 72 72 72 74 118 118 118 121 121 7 17 17 17 87 25 29 18 19 18 18 18 18 18 19 18 18 18 24 91 17 87 2 2 2 2 2 2 90 113 85 114 115 79 72 72 72 72 0 
0 72 72 72 72 74 17 17 17 118 17 118 17 17 17 112 88 25 26 26 26 26 29 18 18 18 18 18 18 24 91 17 112 89 89 89 89 89 89 113 17 17 17 17 79 72 72 72 72 0 
0 73 73 73 73 113 66 121 121 121 7 118 17 17 17 17 112 89 89 89 89 88 23 19 19 18 18 19 18 24 91 17 92 75 75 75 75 75 75 75 75 75 75 111 79 72 72 72 72 0 
0 84 84 84 84 84 111 33 118 118 118 66 17 17 17 17 17 17 17 17 17 87 23 18 18 18 19 19 18 24 91 17 79 72 72 72 72 72 72 72 72 72 72 215 216 72 72 72 72 0 
0 20 21 21 21 22 91 17 17 33 2 118 17 17 17 17 17 17 17 17 17 87 23 18 18 18 18 18 18 24 91 17 79 72 72 72 72 72 72 72 72 72 72 215 216 72 72 72 72 0 
0 31 19 18 18 24 83 111 17 17 17 17 17 17 17 17 17 17 17 17 17 87 23 18 19 19 18 18 18 24 91 17 79 72 72 72 72 72 72 72 72 72 72 215 216 72 72 72 72 0 
0 18 18 18 18 30 22 83 84 84 84 84 84 84 84 84 84 111 17 17 17 87 25 26 26 26 26 26 26 27 91 17 79 72 72 72 72 72 72 72 72 72 72 215 216 72 72 72 72 0 
0 18 18 18 18 18 30 21 21 21 21 21 21 21 21 21 22 83 111 17 17 112 89 89 89 89 89 89 89 89 113 17 79 72 72 72 72 72 72 72 72 72 72 215 216 72 72 72 72 0 
0 19 19 18 18 18 18 18 18 18 18 18 18 18 18 18 30 22 83 111 17 17 17 17 17 17 17 17 17 17 17 17 79 72 72 72 72 72 72 72 72 72 72 215 216 72 72 72 72 0 
0 18 18 18 19 19 18 18 18 18 19 19 18 18 18 18 18 30 22 83 111 17 17 17 17 17 17 17 17 17 17 17 87 217 217 217 217 217 217 217 217 217 217 2 79 72 72 72 72 0 
0 18 18 18 18 19 18 19 18 18 18 18 18 18 19 19 19 18 30 22 83 111 66 66 17 17 17 17 17 17 17 17 87 117 102 102 102 102 102 102 102 103 2 2 79 72 72 72 72 0 
0 18 18 18 18 18 18 18 18 18 18 18 18 18 18 18 18 19 18 30 22 91 17 66 17 17 17 17 17 17 17 17 87 117 102 102 102 102 102 102 102 103 2 2 79 72 72 72 72 0 
0 19 18 18 18 19 18 18 18 18 18 18 19 18 18 18 18 18 18 19 24 91 17 17 17 17 17 17 17 17 17 17 87 116 100 100 100 100 100 100 100 104 2 2 79 72 72 72 72 0 
0 18 18 18 18 18 18 19 18 18 18 18 18 18 18 18 18 18 18 19 24 91 17 17 17 17 17 17 17 17 17 17 87 2 108 107 97 97 107 97 109 2 2 85 79 72 72 72 72 0 
0 18 18 18 18 18 18 18 18 18 18 18 18 18 18 18 18 18 18 18 24 91 17 17 17 17 17 17 17 17 17 17 87 2 108 97 107 97 98 99 109 2 2 85 79 72 72 72 72 0 
0 18 19 19 19 18 18 18 18 18 19 18 18 18 18 18 18 18 18 18 24 91 17 17 17 17 17 17 17 17 17 17 87 2 93 94 96 96 105 94 95 2 2 17 79 72 72 72 72 0 
0 18 19 18 18 18 18 18 18 18 18 18 19 19 19 18 19 19 19 18 24 91 66 17 17 17 17 17 17 17 17 17 87 2 2 91 114 66 87 2 2 2 2 17 79 72 72 72 72 0 
0 18 18 18 18 18 19 18 18 18 18 18 18 18 18 18 18 18 18 18 24 91 17 17 17 17 17 17 17 17 17 17 112 89 89 113 17 17 112 89 89 89 89 66 79 72 72 72 72 0 
0 18 18 18 18 18 18 18 18 18 18 18 18 18 18 18 18 18 18 18 24 91 17 17 17 17 17 17 17 66 17 17 17 17 17 66 17 17 17 17 17 115 17 17 79 72 72 72 72 0 
0 18 18 19 19 18 18 18 19 18 18 18 18 19 18 18 18 19 18 18 24 91 66 17 17 17 223 152 152 152 152 152 152 152 152 152 152 152 152 152 152 152 152 152 152 152 152 152 152 0
0 152 152 152 152 152 152 152 152 152 152 152 152 152 152 152 152 152 152 152 152 220 17 17 17 17 151 155 155 223 152 148 152 152 154 65 155 155 155 155 155 65 155 155 155 155 155 155 155 0
0 155 155 65 155 155 155 223 152 152 154 155 14 223 152 152 152 152 152 152 152 152 220 17 17 85 151 155 155 151 223 152 152 154 153 155 155 223 152 152 152 152 152 152 152 154 14 14 155 0
0 13 155 155 155 155 155 151 65 155 153 155 155 151 155 155 65 155 155 155 223 154 153 17 17 84 151 155 155 151 151 155 157 156 153 155 155 151 65 155 155 223 152 154 155 153 155 155 155 0 
0 154 155 155 155 13 155 151 155 155 153 14 155 151 155 14 155 155 155 155 157 156 153 17 17 89 151 155 155 151 157 158 158 158 156 155 155 151 155 14 155 157 158 156 155 153 155 14 155 0 
0 0 0 0 0 0 0 0 0 0 0 0 0 0 0 0 0 0 0 0 0 0 0 0 0 0 0 0 0 0 0 0 0 0 0 0 0 0 0 0 0 0 0 0 0 0 0 0 0 0 
