0 0 0 0 0 0 0 0 0 0 0 0 0 0 0 0 0 0 0 0 0 0 0 0 0 0 0 0 0 0 0 0 0 0 0 0 0 0 0 0 0 0 0 0 0 0 0 0 0 0 
0 0 0 0 0 0 0 0 0 0 0 0 0 0 0 0 0 0 0 0 0 0 0 0 0 0 0 0 0 0 0 0 0 0 0 0 0 0 0 0 0 0 0 0 0 0 0 0 0 0 
0 0 0 0 0 0 0 0 0 0 0 0 0 0 0 0 0 0 0 0 0 0 0 0 0 0 0 0 0 0 0 0 0 0 0 0 0 0 0 0 0 0 0 0 0 0 0 0 0 0 
0 0 0 0 0 0 0 0 0 0 0 0 0 0 0 0 0 0 0 0 0 0 0 0 0 0 0 0 0 0 0 0 0 0 0 0 0 0 0 0 0 0 0 0 0 0 0 0 0 0 
0 0 0 0 0 0 0 0 0 0 0 0 0 0 0 0 0 0 0 0 0 0 0 0 0 0 0 0 0 0 0 0 0 0 0 0 0 0 0 0 0 0 0 0 0 0 0 0 0 0 
0 0 0 0 0 0 0 0 0 0 0 0 0 0 0 0 0 0 0 0 0 0 0 0 0 0 0 0 0 0 0 0 0 0 0 0 0 0 0 0 0 0 0 0 0 0 0 0 0 0 
0 0 0 0 0 0 0 0 0 0 0 0 0 0 0 0 0 0 0 0 0 0 0 0 0 0 0 0 0 0 0 0 0 0 0 0 0 0 0 0 0 0 0 0 0 0 0 0 0 0 
0 0 0 0 0 0 0 0 72 226 89 89 89 89 89 89 89 89 89 89 89 89 89 203 203 203 203 89 89 89 89 89 89 89 89 89 89 89 89 89 225 72 0 0 0 0 0 0 0 0 
0 0 0 0 0 0 0 0 72 215 17 194 2 194 198 193 198 213 198 193 198 209 198 202 202 202 202 193 198 204 198 209 198 213 198 193 198 194 194 17 216 72 0 0 0 0 0 0 0 0 
0 0 0 0 0 0 0 0 72 215 205 206 204 194 198 204 198 214 198 193 198 210 198 112 89 89 113 204 198 204 198 210 198 214 198 205 206 194 194 17 216 72 0 0 0 0 0 0 0 0 
0 0 0 0 0 0 0 0 72 215 17 115 17 2 194 194 194 194 17 2 194 194 194 2 194 17 17 194 194 204 114 114 115 115 17 194 2 194 17 17 216 72 0 0 0 0 0 0 0 0 
0 0 0 0 0 0 0 0 72 215 17 194 194 2 17 2 194 2 194 2 194 204 194 194 17 208 207 194 204 194 194 194 194 194 114 115 17 17 204 17 216 72 0 0 0 0 0 0 0 0 
0 0 0 0 0 0 0 0 72 215 204 201 2 2 198 193 198 193 198 193 198 213 198 193 198 193 198 204 198 193 198 2 198 193 198 2 204 194 201 204 216 72 0 0 0 0 0 0 0 0 
0 0 0 0 0 0 0 0 72 215 194 201 2 194 198 204 198 193 198 193 198 214 198 204 198 193 198 204 198 193 198 193 198 204 198 193 198 204 201 194 216 72 0 0 0 0 0 0 0 0 
0 0 0 0 0 0 0 0 72 215 17 115 17 92 84 84 84 84 84 84 84 84 84 84 84 84 84 84 84 84 84 84 84 84 84 84 111 17 17 194 216 72 0 0 0 0 0 0 0 0 
0 0 0 0 0 0 0 0 72 215 194 17 17 87 5 5 5 2 5 5 2 5 2 5 5 2 2 2 5 5 5 5 5 5 2 5 91 194 114 17 216 72 0 0 0 0 0 0 0 0 
0 0 0 0 0 0 0 0 72 215 17 201 193 112 89 89 89 89 89 89 89 89 89 89 89 89 89 89 89 89 89 89 89 89 89 89 113 194 201 194 216 72 0 0 0 0 0 0 0 0 
0 0 0 0 0 0 0 0 72 215 17 201 2 2 198 204 198 193 198 193 198 193 198 204 198 193 198 209 198 193 198 212 198 209 198 17 198 194 204 194 216 72 0 0 0 0 0 0 0 0 
0 0 0 0 0 0 0 0 72 215 193 204 193 2 198 204 198 193 198 204 198 193 198 193 17 17 17 210 198 193 198 211 198 210 198 17 198 194 201 204 216 72 0 0 0 0 0 0 0 0 
0 0 0 0 0 0 0 0 72 215 194 17 193 193 193 115 17 193 194 194 194 17 114 115 114 194 194 194 17 17 17 17 194 194 205 206 114 114 17 194 216 72 0 0 0 0 0 0 0 0 
0 0 0 0 0 0 0 0 72 215 2 194 2 193 205 206 2 2 2 193 208 207 194 194 194 194 2 194 194 2 2 204 194 194 2 194 193 194 2 2 216 72 0 0 0 0 0 0 0 0 
0 0 0 0 0 0 0 0 72 215 193 201 17 194 198 2 198 194 2 204 198 204 198 194 17 115 115 213 198 194 198 2 2 2 198 194 198 213 201 193 216 72 0 0 0 0 0 0 0 0 
0 0 0 0 0 0 0 0 72 215 194 212 194 194 198 194 198 204 198 194 198 193 198 194 198 194 198 214 198 204 204 204 198 194 198 17 17 214 201 204 216 72 0 0 0 0 0 0 0 0 
0 0 0 0 0 0 0 0 72 215 193 211 204 92 84 111 92 84 84 84 84 84 84 84 84 84 84 84 84 84 84 84 84 84 84 84 111 194 204 204 216 72 0 0 0 0 0 0 0 0 
0 0 0 0 0 0 0 0 72 215 194 201 194 87 5 91 87 2 5 5 5 5 5 5 5 5 2 5 5 5 2 2 5 5 2 2 91 194 201 193 216 72 0 0 0 0 0 0 0 0 
0 0 0 0 0 0 0 0 72 215 194 201 194 112 89 113 112 89 89 89 89 89 89 89 89 89 89 89 89 89 89 89 89 89 89 89 113 194 201 193 216 72 0 0 0 0 0 0 0 0 
0 0 0 0 0 0 0 0 72 215 204 201 2 193 194 194 193 194 17 194 193 193 193 193 193 193 193 193 194 2 193 193 193 193 193 2 194 194 201 194 216 72 0 0 0 0 0 0 0 0 
0 0 0 0 0 0 0 0 72 215 2 194 200 200 200 209 200 200 200 200 200 200 200 200 208 207 200 200 200 200 200 200 200 200 200 200 200 193 209 194 216 72 0 0 0 0 0 0 0 0 
0 0 0 0 0 0 0 0 72 215 194 205 206 194 194 210 194 208 207 194 194 193 193 193 193 193 194 194 194 17 193 194 194 194 194 17 17 17 210 17 216 72 0 0 0 0 0 0 0 0 
0 0 0 0 0 0 0 0 72 215 132 132 132 132 132 132 194 194 132 132 132 132 132 132 132 205 206 204 193 194 193 92 84 84 84 84 84 84 84 111 216 72 0 0 0 0 0 0 0 0 
0 0 0 0 0 0 0 0 72 215 132 132 132 132 132 132 194 17 132 132 132 132 132 132 132 193 194 194 194 194 204 87 20 21 21 21 21 21 22 91 216 72 0 0 0 0 0 0 0 0 
0 0 0 0 0 0 0 0 72 215 132 132 132 132 132 132 193 193 132 54 54 133 132 132 132 193 194 17 194 194 194 87 23 18 18 19 19 18 24 91 216 72 0 0 0 0 0 0 0 0 
0 0 0 0 0 0 0 0 72 215 132 188 171 185 172 172 172 172 172 190 190 190 172 186 132 17 193 194 92 84 84 86 23 19 19 18 19 19 24 91 216 72 0 0 0 0 0 0 0 0 
0 0 0 0 0 0 0 0 72 215 132 188 172 172 172 172 172 171 172 172 172 172 171 186 132 193 193 193 87 20 21 21 31 18 19 18 18 19 24 91 216 72 0 0 0 0 0 0 0 0 
0 0 0 0 0 0 0 0 72 215 132 188 172 172 171 185 185 185 185 185 185 172 172 186 132 193 193 193 87 23 19 19 19 18 18 19 19 18 24 91 216 72 0 0 0 0 0 0 0 0 
0 0 0 0 0 0 0 0 72 215 132 188 172 172 172 172 172 171 171 172 172 172 172 186 132 193 2 194 87 25 26 29 19 19 19 19 19 18 24 91 216 72 0 0 0 0 0 0 0 0 
0 0 0 0 0 0 0 0 72 215 132 188 172 172 185 185 185 185 185 171 185 171 172 186 132 194 194 194 193 89 88 25 26 26 26 26 26 26 27 91 216 72 0 0 0 0 0 0 0 0 
0 0 0 0 0 0 0 0 72 215 132 188 172 171 171 172 172 172 172 172 172 172 171 186 132 194 194 194 194 194 112 89 89 89 89 89 89 89 89 113 216 72 0 0 0 0 0 0 0 0 
0 0 0 0 0 0 0 0 72 215 132 188 172 172 172 172 171 172 172 185 171 172 171 186 132 194 194 2 193 193 193 203 209 203 212 203 213 17 17 17 216 72 0 0 0 0 0 0 0 0 
0 0 0 0 0 0 0 0 72 215 132 132 132 132 132 132 132 132 132 132 132 132 132 132 132 205 206 193 17 193 193 202 210 202 211 202 214 202 193 193 216 72 0 0 0 0 0 0 0 0 
0 0 0 0 0 0 0 0 72 227 218 218 218 218 218 218 218 218 218 218 218 218 218 218 218 2 2 2 2 2 218 218 218 218 218 218 218 218 218 218 224 72 0 0 0 0 0 0 0 0 
0 0 0 0 0 0 0 0 72 72 72 72 72 72 72 72 72 72 72 72 72 72 72 72 72 215 2 2 2 216 72 72 72 72 72 72 72 72 72 72 72 72 0 0 0 0 0 0 0 0 
0 0 0 0 0 0 0 0 0 0 0 0 0 0 0 0 0 0 0 0 0 0 0 0 0 0 0 0 0 0 0 0 0 0 0 0 0 0 0 0 0 0 0 0 0 0 0 0 0 0 
0 0 0 0 0 0 0 0 0 0 0 0 0 0 0 0 0 0 0 0 0 0 0 0 0 0 0 0 0 0 0 0 0 0 0 0 0 0 0 0 0 0 0 0 0 0 0 0 0 0 
0 0 0 0 0 0 0 0 0 0 0 0 0 0 0 0 0 0 0 0 0 0 0 0 0 0 0 0 0 0 0 0 0 0 0 0 0 0 0 0 0 0 0 0 0 0 0 0 0 0 
0 0 0 0 0 0 0 0 0 0 0 0 0 0 0 0 0 0 0 0 0 0 0 0 0 0 0 0 0 0 0 0 0 0 0 0 0 0 0 0 0 0 0 0 0 0 0 0 0 0 
0 0 0 0 0 0 0 0 0 0 0 0 0 0 0 0 0 0 0 0 0 0 0 0 0 0 0 0 0 0 0 0 0 0 0 0 0 0 0 0 0 0 0 0 0 0 0 0 0 0 
0 0 0 0 0 0 0 0 0 0 0 0 0 0 0 0 0 0 0 0 0 0 0 0 0 0 0 0 0 0 0 0 0 0 0 0 0 0 0 0 0 0 0 0 0 0 0 0 0 0 
0 0 0 0 0 0 0 0 0 0 0 0 0 0 0 0 0 0 0 0 0 0 0 0 0 0 0 0 0 0 0 0 0 0 0 0 0 0 0 0 0 0 0 0 0 0 0 0 0 0 
0 0 0 0 0 0 0 0 0 0 0 0 0 0 0 0 0 0 0 0 0 0 0 0 0 0 0 0 0 0 0 0 0 0 0 0 0 0 0 0 0 0 0 0 0 0 0 0 0 0 
